的	得 德 色 客 野 嚒 搭 爹 肚 饿 渴 肋 赫 睹 啧
是	什 实 师 试 世 视 式 使 失 识 示 士 适 饰 狮
一	意 已 衣 益 依 异 疑 忆 亿 译 翼 谊 椅 溢 怡
不	部 步 补 布 币 逼 巨 捕 怖 卜 埠 簿 哺 惚 卟
了	乐 歌 德 客 河 刻 夜 旅 绿 肋 叻 撸 吕 搁 鹤
有	又 游 由 优 油 右 邮 尤 幼 幽 诱 呦 佑 酉 釉
我	误 握 卧 窝 污 挖 哇 沃 涡 喔 颇 倭 蜗 捂 鳌
人	然 文 认 任 忍 仁 闷 笨 纹 愤 苯 扔 韧 壬 刃
个	格 歌 各 哥 革 隔 割 戈 葛 鸽 阁 搁 棵 菇 噩
在	再 海 孩 载 牌 罪 灾 胎 呆 碍 埃 欸 栽 宰 哉
你	立 尼 拟 敌 泥 逆 妮 碍 埃 腻 伱 倪 霓 匿 昵
这	着 者 查 至 折 喆 哲 浙 竹 蛇 枝 振 赫 遮 辙
就	九 究 酒 久 救 旧 纠 舅 揪 玖 韭 灸 钮 疚 鹫
要	约 药 奥 摇 邀 腰 妖 耀 饱 遥 咬 谣 岆 瑶 姚
好	海 号 药 豪 潮 貌 毫 耗 浩 凹 涛 烤 嚎 昊 壕
大	打 达 答 搭 抵 罚 娜 塔 旦 敌 戴 玛 娃 胆 挖
上	长 商 张 山 伤 双 章 升 账 尚 赏 障 昇 胀 甸
么	门 呢 何 歌 河 刻 夜 嚒 魔 蜜 液 摸 瑟 沫 禾
以	意 已 衣 益 依 异 疑 忆 亿 译 翼 谊 椅 溢 怡
会	回 惠 汇 挥 灰 悔 辉 徽 毁 绘 恢 贿 讳 卉 晖
来	代 再 嘅 赖 莱 埃 璃 唻 歪 粒 汰 沥 垒 睐 岚
到	道 导 倒 跑 岛 刀 盗 扰 耗 袋 腰 蹈 稻 捣 嫂
学	解 续 血 询 雪 阅 鞋 讯 巡 泄 叙 岳 蝎 歇 卸
中	种 重 整 终 众 钟 郑 症 崇 忠 洪 纵 仲 肿 衷
时	什 实 师 试 世 视 式 使 失 识 示 士 适 饰 狮
为	位 微 味 谓 慰 伪 胃 薇 魏 韦 畏 惟 猥 萎 玮
们	每 认 民 门 梦 闷 笨 纹 眉 玫 蚊 闽 檬 焖 朦
能	男 白 难 台 南 奶 拜 盖 耐 奈 挨 哀 恼 乃 亥
可	科 客 课 责 克 刻 颗 渴 壳 柯 鸽 磕 棵 苛 坷
点	电 店 段 限 典 蛋 垫 歉 莲 廉 辨 吊 颠 淀 殿
都	度 读 独 毒 督 盾 杜 赌 肚 渡 堵 妒 嘟 睹 镀
生	成 神 声 省 升 胜 圣 盛 症 剩 昇 牲 绳 甸 睁
多	括 夺 朵 拓 哆 躲 堕 挪 怼 剁 惰 舵 跺 糯 蓑
说	水 书 试 世 视 式 术 使 税 睡 束 树 湿 挥 饰
也	业 何 歌 夜 爷 野 页 叶 宇 液 耶 椰 冶 吁 噎
没	美 每 微 妹 媒 梅 煤 呗 魅 眉 玫 霉 枚 贼 昧
国	过 果 左 伙 鬼 锅 郭 柜 洛 跪 裹 卦 咕 磋 咄
和	合 呢 设 何 社 则 呵 河 核 喝 盒 荷 吓 赫 贺
看	饭 盘 谈 范 慢 凯 刊 堪 砍 坎 侃 勘 炭 攒 扳
自	子 资 字 咨 仔 紫 姿 滋 兹 籽 淄 梓 疵 呲 渍
年	变 先 男 见 念 坚 免 剑 潜 兼 迁 践 贱 淀 黏
还	哈 海 号 孩 害 择 毫 艾 嘿 哀 晒 宅 咳 罕 霾
他	她 图 妈 它 达 马 塔 踏 瓦 鸭 叭 爬 塌 祂 惕
零	领 另 灵 令 龄 凌 玲 铃 陵 岭 菱 聆 伶 拎 羚
二	而 儿 哦 尔 恩 耳 饿 鹅 诶 饵 厄 遏 贰 娥 讹
家	加 价 假 佳 架 驾 甲 嘉 嫁 夹 贾 迦 钾 戛 颊
过	国 果 座 左 伙 鬼 锅 郭 柜 洛 裹 卦 咕 磋 咄
子	自 资 字 咨 仔 紫 姿 滋 兹 孜 籽 淄 梓 呲 渍
得	的 德 客 达 读 底 哥 抵 隔 妒 磕 冶 棵 褐 旳
对	度 第 队 底 岁 贷 递 堆 碎 轨 催 兑 桂 敦 硅
下	谢 细 夏 席 侠 瞎 霞 虾 辖 锡 袖 峡 狭 暇 瑕
出	处 初 除 楚 础 触 叔 扯 珠 储 厨 柱 橱 雏 锄
那	哪 哈 拿 码 亚 怕 纳 罚 娜 涯 哒 呐 噶 趴 崖
发	法 服 亚 怕 饭 附 罚 乏 伏 覆 涯 伐 祂 阀 哑
天	先 见 健 田 填 甜 迁 坛 践 鉴 添 淀 箭 舔 恬
后	候 收 又 否 扣 偶 搜 透 厚 猴 抖 侯 吼 喉 搂
很	粉 圳 奋 震 奔 恨 汗 纹 尘 狠 臣 痕 嫩 肾 浑
用	总 永 童 拥 勇 贡 庸 婴 泳 涌 佣 咏 垄 雍 甬
去	区 取 组 曲 趣 趋 驱 屈 渠 棋 娶 瑜 躯 佢 乞
业	也 呢 夜 爷 野 页 叶 液 耶 禾 椰 冶 噎 烨 琊
心	新 信 音 训 惜 欣 辛 薪 勤 芯 鑫 牺 峡 寝 斌
现	限 县 鲜 献 闲 仙 陷 嫌 羡 咁 宪 咸 掀 衔 腺
地	第 低 底 弟 递 帝 滴 迪 抵 敌 蒂 堤 笛 旳 缔
想	相 像 向 象 项 讲 响 香 享 降 乡 箱 详 翔 祥
行	性 向 星 精 形 型 兴 幸 醒 欣 姓 刑 馨 厢 菱
三	山 班 干 演 含 散 犯 懒 诞 潘 宴 叛 咽 伞 绊
作	做 活 货 座 左 坐 族 昨 醉 囖 豁 佐 琢 皂 撮
成	程 城 承 陈 诚 盛 乘 症 虫 撑 呈 肠 辰 趁 秤
十	事 什 实 师 试 世 视 式 使 失 识 示 士 适 饰
理	里 利 立 离 例 丽 励 黎 厘 栗 吏 俐 俪 珞 笠
事	什 实 师 试 世 视 式 使 失 识 示 士 适 饰 狮
小	先 笑 消 销 效 跳 晓 孝 肖 萧 削 宵 潇 嚣 霄
分	认 门 份 飞 粉 凡 奋 纷 喷 笨 纹 氛 愤 芬 逢
开	待 卖 态 嘅 凯 堪 迈 烤 蔡 宰 哉 慨 霾 歹 黛
工	公 东 功 共 供 攻 恐 宫 贡 恭 泳 踪 颂 弘 溶
如	入 故 诉 付 孤 吴 宇 虎 予 乳 狱 腹 雾 肃 辱
本	文 认 班 忍 奔 呗 颁 笨 芬 盆 苯 甭 汾 惫 摁
最	制 随 坐 罪 址 尊 嘴 柜 植 亏 醉 溃 翠 咀 淄
什	实 师 试 世 视 式 使 失 识 示 士 适 饰 狮 驶
里	理 利 立 离 例 丽 励 黎 厘 栗 吏 俐 俪 珞 笠
公	工 东 功 共 供 攻 恐 宫 贡 恭 泳 踪 颂 弘 溶
方	让 放 房 养 防 访 央 棒 抗 繁 旁 凤 仿 芳 脏
实	什 师 试 世 视 式 使 失 识 示 士 适 饰 狮 驶
经	精 京 境 警 竟 静 竞 镜 净 敬 睛 径 晶 殑 荆
情	请 清 亲 评 青 轻 另 庆 订 抢 倾 晴 寝 卿 擎
样	养 阳 杨 央 洋 扬 羊 邦 仰 氧 旸 痒 烊 秧 漾
于	育 誉 愉 郁 愚 狱 愈 寓 俞 吁 驭 钰 禺 芋 煜
道	到 宝 导 告 倒 跑 岛 刀 盗 扰 耗 袋 腰 矛 蹈
动	东 农 懂 痛 弄 冬 宗 洞 董 浓 邓 冻 庸 桶 栋
五	无 务 午 舞 误 屋 污 乌 伍 雾 呜 勿 吾 巫 坞
电	点 店 段 限 典 蛋 牵 垫 莲 廉 辨 吊 颠 淀 殿
定	并 顶 冰 宁 惊 订 丁 洞 井 鼎 钉 盯 叮 靖 荧
己	机 几 系 计 及 技 集 即 纪 继 鸡 肌 寂 挤 稽
机	己 几 系 计 及 技 集 即 纪 继 鸡 肌 寂 挤 稽
面	便 限 连 免 贤 垫 眠 肩 歉 莲 苗 谦 棉 绵 勉
之	知 只 直 至 指 支 置 止 织 纸 枝 脂 汁 肢 秩
我	误 握 卧 窝 污 挖 哇 沃 涡 喔 颇 倭 蜗 捂 鳌
然	玩 兰 染 胆 甘 曼 胖 燃 肝 翰 澜 罕 潭 壤 冉
文	问 微 温 卫 粉 闻 稳 纷 纹 吻 畏 挽 丸 雯 蚊
高	告 搞 猫 暴 泡 稿 糕 恼 膏 茅 镐 凿 皋 羔 睾
所	活 速 索 损 锁 缩 塑 囖 琐 梭 嗦 跺 蓑 唑 嚯
问	文 微 温 卫 粉 闻 稳 纷 纹 吻 畏 挽 丸 雯 蚊
给	位 费 该 每 贵 革 威 倍 废 伪 玫 蕾 阁 匪 钙
知	直 至 指 支 职 置 止 织 纸 枝 脂 旨 吱 肢 秩
爱	细 哎 艾 疾 亦 唉 碍 埃 欸 挨 哀 癌 凹 矮 暧
做	作 活 货 座 左 坐 族 昨 醉 螺 佐 琢 皂 撮 藻
法	发 服 亚 怕 饭 附 罚 乏 伏 覆 伐 砸 祂 阀 哑
四	司 思 死 斯 食 激 似 丝 私 撕 寺 肆 饲 嘶 厮
意	已 衣 益 依 异 疑 忆 亿 译 姨 翼 谊 椅 溢 怡
主	助 祝 筑 猪 逐 珠 竹 驻 柱 煮 丶 烛 株 嘱 铸
新	心 信 线 音 欣 辛 薪 勤 芯 鑫 峡 寝 斌 锌 昕
力	理 里 利 立 离 礼 例 励 黎 厘 栗 哩 吏 俐 俪
着	这 者 至 核 折 喆 哲 浙 竹 蛇 枝 振 赫 遮 辙
手	数 收 书 受 首 州 售 守 搜 舒 授 丑 寿 兽 暑
前	钱 签 潜 迁 欠 牵 歉 遣 铅 乾 倩 嵌 谴 黔 钳
同	通 总 统 痛 童 铜 筒 桶 栋 桐 彤 瞳 珑 聋 捅
啊	阿 啦 按 码 亚 怕 爸 呀 额 巴 压 芽 讶 哑 靶
真	镇 针 珍 圳 阵 诊 振 侦 贞 甄 枕 帧 疹 臻 朕
话	化 哈 或 花 华 画 划 获 汇 滑 瓜 徽 恢 哗 蛤
只	知 直 至 指 支 置 止 织 纸 枝 脂 旨 肢 秩 挚
感	干 敢 赶 残 甘 艳 盐 憾 杆 肝 尴 镐 赣 棺 樊
些	解 谢 协 鞋 械 邪 谐 蟹 携 泄 蝎 歇 卸 胁 斜
果	国 过 左 伙 鬼 锅 郭 柜 洛 跪 哆 裹 卦 咕 呱
回	会 汇 挥 慧 灰 悔 辉 徽 毁 绘 恢 贿 讳 卉 晖
种	中 重 终 众 争 钟 郑 症 忠 纵 仲 肿 衷 仗 弘
美	没 每 微 备 妹 媒 梅 煤 呗 魅 眉 玫 霉 枚 诶
网	望 玩 帮 王 往 忘 亡 糖 旁 汤 仿 旺 汪 妄 葬
老	报 号 络 倒 跑 劳 闹 牢 捞 姥 佬 拦 唠 烙 锣
而	二 儿 哦 尔 恶 恩 耳 饿 饵 噩 厄 遏 贰 迩 胺
关	管 原 观 官 馆 惯 冠 钻 逛 援 贯 灌 莞 罐 渊
全	管 权 券 冠 迁 患 缓 欠 怨 泉 劝 拳 犬 诠 醛
日	吸 尼 鸡 币 弃 逼 忆 吉 辑 既 瓷 媲 翌 肄 弋
比	毕 笔 币 逼 避 闭 彼 壁 碧 鄙 弊 辟 臂 蔽 屄
间	件 简 检 坚 健 减 荐 键 鉴 尖 舰 奸 贱 煎 捡
女	那 哪 拿 嗯 律 率 尼 拟 娜 逆 怒 腻 虐 霓 匿
起	其 七 气 器 妻 戚 棋 琦 凄 祁 麒 迄 杞 祺 亟
信	心 新 线 音 欣 辛 薪 勤 芯 鑫 峡 寝 斌 锌 昕
无	务 武 舞 吴 悟 乌 伍 雾 呜 勿 唔 坞 侮 梧 捂
通	同 总 统 痛 童 综 铜 筒 桶 讼 桐 彤 瞳 聋 捅
其	七 气 妻 旗 欺 戚 棋 歧 琪 栖 崎 绮 脐 麒 迄
明	名 影 民 请 并 命 硬 竞 凌 鸣 铭 钉 冥 汀 茗
吧	八 把 哈 步 拿 爸 巴 娃 拔 芭 罢 叭 疤 坝 靶
长	种 装 张 伤 章 钟 掌 账 涨 障 帐 杭 丈 胀 倡
体	题 提 激 替 徒 梯 踢 剔 唧 畸 惕 蹄 涕 剃 嚏
八	吧 把 哈 步 拿 爸 巴 娃 拔 芭 罢 叭 疤 坝 靶
市	事 什 实 师 试 世 视 式 使 失 识 示 士 适 饰
题	体 提 激 替 徒 梯 踢 剔 唧 畸 惕 蹄 涕 剃 嚏
打	大 达 答 搭 骂 迪 牙 娜 塔 旦 敌 戴 玛 娃 胆
因	音 研 银 引 印 阴 隐 饮 姻 淫 瘾 吟 殷 尹 颐
月	越 阅 页 悦 跃 岳 玥 渔 於 粤 曰 穴 逾 瑜 椰
合	和 何 德 户 呵 河 核 喝 湖 虎 涉 盒 荷 吓 赫
六	流 历 留 刘 漏 裂 黎 柳 浏 溜 瘤 榴 陋 硫 琉
考	早 造 靠 淘 烤 骚 阔 躁 澡 砍 坎 岆 瑶 拷 曜
当	帮 党 档 丁 扬 抗 冬 荡 挡 妄 烫 琅 乓 裆 宕
者	这 着 至 折 喆 哲 浙 竹 蛇 枝 振 赫 遮 辙 褶
但	单 待 验 担 蛋 淡 丹 旦 胆 诞 耽 叨 拌 氮 郸
怎	文 问 门 根 增 温 曾 赞 闻 稳 仁 氛 蚊 啃 汾
部	不 步 补 布 币 逼 巨 捕 怖 卜 埠 簿 哺 惚 卟
九	就 近 究 酒 久 救 旧 纠 舅 揪 玖 韭 灸 钮 疚
活	或 货 火 获 昨 伙 魂 扩 惑 霍 祸 豁 壕 灬 镯
别	毕 笔 憋 瘪 鳖 聂 膊 邂 痹 缤 陛 榭 殡 偕 秸
觉	决 局 绝 届 皆 掘 爵 诀 崛 峻 抉 睫 倔 厥 獗
性	行 星 精 英 形 型 兴 幸 醒 姓 刑 盈 祥 馨 菱
进	金 今 音 近 尽 频 仅 紧 津 禁 劲 斤 锦 谨 晋
加	家 价 假 佳 架 驾 甲 嘉 嫁 挤 夹 贾 迦 钾 戛
吗	妈 马 码 亚 怕 米 嘛 麻 猫 骂 玛 涯 祂 啪 沫
重	中 种 整 终 众 钟 郑 症 崇 忠 洪 纵 仲 肿 衷
应	影 英 营 迎 硬 映 盈 颖 婴 鹰 樱 莹 荧 萤 莺
车	具 据 剧 局 句 居 举 巨 聚 距 拒 俱 拘 矩 菊
等	当 登 灯 仍 碰 邓 彭 橙 澄 蹭 盯 耿 懵 凳 瞪
资	自 子 字 咨 紫 姿 滋 兹 籽 淄 梓 疵 呲 渍 姊
表	交 报 标 叫 效 料 挑 缴 尿 剥 朴 飙 彪 婊 僚
次	此 词 急 笔 礼 击 材 刺 辞 圾 磁 慈 瓷 赐 茨
与	于 育 愉 郁 愚 狱 愈 寓 俞 吁 驭 钰 禺 芋 煜
让	房 望 防 党 仿 荡 邦 杭 仰 杠 壤 肪 镑 琅 乓
相	想 像 向 象 项 讲 响 香 享 醒 乡 箱 详 翔 祥
品	片 音 尽 频 临 拼 贫 淋 潘 匹 鑫 叛 钦 沁 吝
正	证 政 整 终 争 征 郑 症 挣 肿 衷 蒸 拯 睁 筝
安	男 反 案 阿 按 暗 傲 岸 燕 俺 氨 鞍 敖 晏 斓
金	进 今 近 尽 频 仅 紧 津 禁 劲 斤 锦 肩 谨 晋
外	未 待 卖 态 载 牌 财 彩 赛 喂 癌 胃 弯 迈 蔡
两	量 响 香 亮 良 辆 梁 凉 粮 狼 玲 谅 疆 浆 靓
产	场 常 茶 惨 缠 唇 阐 禅 馋 蝉 悍 掺 铲 绽 姗
名	明 影 民 请 并 命 硬 竞 凌 鸣 铭 钉 秉 冥 汀
少	号 照 山 善 绍 烧 稍 扫 衫 砂 昊 邵 哨 皓 烁
她	他 图 妈 它 达 塔 踏 瓦 鸭 叭 爬 塌 祂 惕 咔
期	其 七 气 器 妻 旗 戚 棋 凄 祁 麒 迄 杞 祺 亟
司	四 思 死 斯 食 礼 击 似 丝 私 撕 寺 肆 饲 嘶
内	位 备 委 赔 倍 废 泥 眉 佩 玫 伱 蕾 韦 匪 惟
教	交 较 叫 角 脚 缴 焦 胶 娇 椒 矫 搅 蕉 浇 饺
买	该 每 孩 待 卖 态 嘛 毛 拜 败 猫 蜜 莱 戴 麦
场	常 唱 承 章 厂 偿 昌 尝 畅 撑 肠 倡 惩 敞 樟
单	但 待 验 担 蛋 淡 丹 旦 胆 诞 耽 叨 拌 蚕 氮
七	其 期 气 器 妻 旗 戚 棋 凄 祁 麒 迄 杞 祺 亟
更	冷 攻 仍 凤 猛 逢 杠 耕 梗 庚 蓬 缸 弓 耿 憎
度	都 读 独 毒 督 谱 怒 乌 杜 赌 肚 渡 堵 妒 嘟
才	孩 财 彩 材 采 菜 操 泰 残 裁 猜 擦 磁 碍 蔡
师	什 实 市 试 世 视 式 使 失 识 示 士 适 饰 驶
常	场 唱 章 厂 偿 昌 尝 畅 撑 肠 倡 惩 敞 樟 漳
东	动 农 懂 痛 弄 冬 宗 洞 董 浓 邓 冻 庸 桶 鼎
解	些 谢 写 协 鞋 械 邪 蟹 携 泄 蝎 歇 卸 胁 斜
位	微 未 维 委 味 卫 威 谓 违 尾 慰 喂 胃 薇 畏
几	己 机 集 击 激 辑 既 寂 忌 稽 饥 姬 嫉 脊 妓
化	话 哈 或 花 华 画 划 获 汇 滑 瓜 徽 恢 哗 蛤
系	己 机 集 击 激 辑 既 寂 忌 稽 饥 姬 嫉 脊 妓
太	白 台 态 讨 嘅 奶 泰 胎 踏 呆 抬 歪 汰 惕 苔
把	吧 八 步 拿 爸 巴 娃 拔 芭 罢 叭 疤 坝 靶 蛤
务	无 物 午 舞 误 屋 污 乌 伍 雾 呜 勿 吾 巫 坞
被	批 皮 屁 脾 疲 匹 啤 劈 癖 坯 霹 琵 毗 媲 丕
提	体 题 替 梯 踢 剔 漓 觅 唧 畸 惕 蹄 涕 剃 嚏
百	白 包 宝 台 改 版 拜 败 哎 摆 柏 哀 罢 剥 栽
乐	了 歌 德 各 河 刻 夜 旅 肋 叻 撸 吕 搁 鹤 涩
从	童 藏 综 聪 贡 洪 恭 葱 匆 丛 哄 沧 憧 珑 聋
保	报 号 办 包 宝 抱 爆 暴 薄 拔 饱 堡 遥 剥 胞
友	又 游 优 油 右 邮 尤 幼 忧 幽 悠 犹 诱 呦 佑
候	后 收 又 头 口 否 扣 偶 搜 透 抽 厚 猴 抖 侯
量	两 香 亮 良 降 辆 梁 凉 粮 狼 玲 谅 疆 浆 靓
计	己 机 集 击 激 辑 既 寂 忌 稽 饥 姬 嫉 脊 妓
西	喜 习 吸 媳 晰 稀 溪 夕 兮 茜 犀 烯 熄 嬉 羲
证	正 政 整 终 争 征 郑 症 挣 肿 衷 蒸 拯 睁 筝
费	美 非 飞 肥 菲 废 喂 啡 肺 妃 匪 沸 绯 翡 斐
接	节 界 姐 介 借 阶 届 杰 截 揭 捷 戒 皆 劫 羯
目	母 努 府 顾 舞 木 陆 幕 慕 姆 牧 墓 募 瑜 穆
钱	前 千 签 潜 迁 欠 牵 歉 遣 铅 乾 倩 嵌 谴 黔
喜	西 习 吸 媳 晰 稀 溪 夕 兮 茜 犀 烯 熄 嬉 羲
第	地 低 底 弟 递 帝 滴 迪 抵 敌 蒂 堤 笛 旳 缔
身	神 深 申 审 甚 沈 诊 伸 慎 肾 渗 杉 绅 婶 莘
数	书 术 熟 述 输 束 树 叔 暑 蔬 抒 赎 薯 枢 恕
代	带 改 待 嘚 贷 哎 搭 戴 呆 袋 栽 歹 黛 亥 暧
已	意 衣 益 依 异 疑 忆 亿 译 翼 谊 椅 溢 怡 臆
再	在 海 孩 载 牌 罪 灾 胎 植 碍 埃 欸 栽 宰 哉
员	运 云 孕 允 晕 韵 蕴 匀 熏 芸 酝 耘 陨 昀 熨
哪	那 哈 拿 码 亚 怕 纳 罚 娜 涯 哒 呐 噶 趴 崖
价	家 加 假 佳 架 驾 甲 嘉 嫁 夹 贾 瑕 迦 钾 戛
直	知 只 至 指 支 置 止 织 纸 枝 脂 旨 肢 秩 挚
该	海 改 载 财 害 概 菜 盖 泰 鬼 奈 肝 矮 抬 尬
欢	换 环 幻 患 缓 泉 涵 汗 唤 焕 桓 痪 寰 浣 宦
平	评 轻 兴 订 兵 聘 凭 瓶 苹 旁 萍 坪 擎 蓬 乒
结	接 节 界 姐 借 阶 届 杰 截 揭 捷 戒 皆 劫 羯
专	欢 展 转 装 传 环 赚 占 抓 幻 砖 唤 粘 撰 桓
影	应 英 营 迎 硬 映 盈 颖 婴 鹰 樱 莹 荧 萤 莺
物	无 务 午 舞 误 吴 屋 污 乌 伍 雾 呜 勿 吾 巫
交	教 较 叫 角 脚 缴 焦 胶 娇 骄 郊 矫 浇 轿 嚼
报	保 号 办 包 宝 抱 爆 暴 薄 拔 饱 堡 遥 剥 胞
管	关 原 观 官 馆 惯 冠 钻 逛 援 贯 灌 莞 罐 渊
入	如 故 诉 付 孤 吴 宇 虎 予 乳 狱 腹 雾 肃 辱
每	没 美 备 妹 媒 梅 煤 呗 魅 眉 玫 霉 枚 贼 妃
件	间 监 减 荐 键 剑 兼 践 鉴 剪 艰 肩 奸 贱 煎
特	格 科 呢 何 歌 德 河 刻 液 踏 盒 泽 阁 鹅 祂
水	说 书 试 世 视 式 术 使 税 睡 束 树 湿 挥 饰
一	意 已 衣 益 依 异 疑 忆 亿 译 翼 谊 椅 溢 怡
哈	海 号 孩 何 茶 豪 傻 耗 辣 狐 叉 诈 撼 吖 刹
快	开 款 块 怀 亏 馈 淮 拐 葵 恺 徊 筷 铠 匮 槐
求	球 牛 秋 纠 秦 仇 丘 邱 囚 谬 糗 矜 裘 酋 衢
或	活 货 火 获 昨 伙 拖 魂 扩 惑 霍 祸 豁 壕 灬
认	人 本 任 稳 忍 仁 吻 嫩 韧 壬 刃 粪 汶 垦 饪
程	成 城 唱 承 诚 盛 乘 症 撑 呈 肠 辰 趁 秤 惩
格	个 歌 各 哥 革 隔 割 戈 葛 鸽 阁 搁 菇 噩 坷
民	命 敏 蛮 秦 邻 淫 殷 闽 旻 闵 悯 谩 矜 泯 胤
制	知 只 直 至 指 支 置 止 织 纸 枝 脂 肢 秩 挚
请	情 清 亲 评 青 轻 庆 订 抢 倾 晴 寝 卿 擎 氢
科	可 客 课 克 刻 页 颗 渴 壳 柯 磕 棵 苛 坷 珂
服	付 父 富 附 妇 符 幅 傅 伏 抚 腹 弗 辐 缚 俯
流	六 历 留 刘 漏 裂 黎 柳 浏 溜 瘤 榴 陋 硫 琉
建	间 件 监 减 荐 键 剑 兼 践 鉴 剪 肩 奸 贱 煎
语	于 育 愉 郁 愚 狱 愈 寓 俞 吁 驭 钰 禺 芋 煜
海	还 哈 号 孩 害 择 毫 艾 嘿 哀 晒 宅 咳 罕 歹
这	着 者 查 至 折 喆 哲 浙 竹 蛇 枝 振 赫 遮 辙
儿	二 而 哦 尔 恶 恩 耳 饿 饵 噩 厄 遏 贰 迩 胺
记	己 机 几 系 计 基 际 绩 鸡 疾 圾 忌 稽 祭 棘
完	万 玩 晚 湾 挖 弯 碗 挽 塆 丸 婉 楠 顽 腕 宛
利	理 里 力 立 历 礼 例 丽 励 莉 隶 哩 漓 犁 篱
收	手 数 书 受 首 售 守 舒 授 丑 寿 兽 瘦 鼠 署
号	好 海 药 豪 潮 毫 傲 耗 浩 凹 涛 烤 嚎 昊 壕
需	许 续 须 序 虚 绪 徐 蓄 叙 旭 畜 絮 恤 婿 钨
书	数 属 熟 述 输 束 树 叔 暑 抒 赎 薯 竖 枢 恕
办	反 玩 帮 班 版 半 般 板 伴 探 坛 搬 颁 斑 扮
谢	些 解 写 协 鞋 械 邪 谐 携 泄 蝎 歇 卸 胁 斜
又	游 优 油 右 邮 尤 幼 忧 幽 悠 犹 诱 呦 佑 酉
基	己 机 几 系 计 记 际 绩 鸡 疾 圾 忌 稽 祭 棘
区	去 取 组 曲 趣 趋 驱 屈 渠 棋 娶 躯 佢 咕 乞
找	照 招 赵 炒 召 槽 炸 躁 兆 罩 昭 爪 肇 拙 哨
门	们 每 认 民 梦 闷 笨 纹 眉 玫 枚 蚊 檬 焖 朦
孩	还 哈 海 号 害 择 毫 艾 嘿 哀 晒 宅 咳 罕 歹
路	录 绿 鲁 鹿 炉 卢 碌 撸 芦 璐 禄 噜 泸 虏 麓
头	楼 优 投 土 突 扣 搜 透 偷 奏 柔 兔 逗 猴 剖
气	起 器 欺 骑 戚 漆 琪 崎 祁 麒 迄 杞 亟 骐 憩
受	手 数 收 书 首 售 守 舒 授 丑 寿 兽 瘦 鼠 署
原	院 元 远 源 愿 园 缘 圆 怨 援 袁 苑 冤 渊 媛
商	上 长 张 山 伤 双 章 升 账 尚 赏 障 昇 胀 甸
试	什 实 市 师 世 视 式 使 失 识 示 士 适 饰 驶
世	什 实 市 师 试 视 式 使 失 识 示 士 适 饰 驶
变	片 边 编 荐 键 遍 辩 辨 贬 殿 宪 煎 捡 鞭 黔
校	交 较 叫 角 脚 缴 焦 胶 娇 骄 椒 矫 搅 蕉 浇
并	请 病 冰 兵 屏 凌 饼 丙 泵 钉 秉 柄 濒 炳 菁
思	四 司 死 斯 食 激 似 丝 私 撕 寺 肆 饲 畸 嘶
视	什 实 市 师 试 世 式 使 失 识 示 士 适 饰 驶
总	重 空 控 曾 综 宗 宏 纵 泳 踪 弘 垄 巩 瞳 棕
呢	色 客 拿 热 拟 隔 娜 鹤 涩 捏 椰 磕 冶 棵 疟
设	社 示 摄 舍 射 涉 彻 氏 吓 蛇 奢 舌 嘘 仕 竖
放	方 房 防 杨 访 央 凡 钢 仿 泛 芳 坊 妨 纺 庞
式	什 实 市 师 试 世 视 使 失 识 示 士 适 饰 驶
北	费 备 背 卫 悲 贝 雷 违 辈 杯 倍 呗 碑 卑 佰
何	和 合 呢 设 则 呵 河 核 喝 虎 盒 荷 吓 赫 贺
带	代 导 改 待 嘚 贷 哎 搭 戴 呆 袋 哀 歹 黛 暧
复	服 付 父 富 附 妇 符 幅 傅 伏 抚 腹 弗 辐 缚
先	现 限 县 鲜 献 闲 仙 陷 羡 咁 咸 掀 衔 腺 馅
论	运 讯 轮 伦 晕 循 鹿 遵 裸 沦 屯 麟 缆 璐 卤
院	原 元 远 源 愿 园 缘 圆 怨 援 袁 苑 冤 渊 媛
歌	个 格 各 哥 革 隔 割 戈 葛 鸽 阁 搁 菇 噩 坷
吃	处 持 止 织 迟 池 尺 赤 痴 驰 齿 耻 斥 侈 翅
将	像 讲 江 奖 降 镜 净 渐 抢 疆 姜 酱 贱 囧 蒋
男	难 南 奶 颜 咱 惨 燃 摊 栏 呐 婉 谭 衍 旱 楠
习	西 喜 息 希 吸 惜 媳 晰 夕 锡 兮 隙 玺 烯 嬉
房	方 放 防 杨 访 央 凡 洋 钢 仿 绑 泛 芳 坊 妨
口	友 候 构 某 苦 扣 酷 幼 奏 呦 吼 枯 抠 逅 嗽
像	想 相 向 象 项 响 香 享 乡 箱 详 梁 翔 祥 贤
见	间 件 监 减 荐 键 剑 兼 践 鉴 剪 肩 奸 贱 煎
非	费 飞 肥 菲 废 啡 肺 霉 妃 匪 沸 莓 绯 翡 斐
错	活 措 惑 夺 哆 挫 翠 豁 醋 嗦 搓 蓑 璀 磋 厝
算	观 山 款 权 远 段 团 环 酸 渊 衫 杉 娟 蒜 诠
你	立 尼 拟 敌 泥 逆 妮 碍 埃 腻 伱 倪 霓 匿 昵
任	人 本 认 门 稳 忍 仁 吻 苯 嫩 韧 壬 刃 粪 汶
今	进 金 音 近 尽 仅 紧 阴 津 禁 劲 斤 锦 肩 谨
政	正 证 整 终 争 征 郑 症 挣 肿 衷 蒸 拯 睁 筝
听	平 命 评 挺 停 庭 厅 龄 玲 铜 婷 亭 樱 廷 霆
级	己 机 几 系 计 记 基 际 鸡 疾 圾 忌 稽 祭 棘
望	网 玩 帮 王 往 忘 亡 糖 旁 汤 仿 旺 汪 妄 葬
德	的 得 客 达 读 底 哥 抵 隔 妒 磕 冶 棵 褐 旳
社	设 使 示 摄 舍 射 涉 彻 氏 吓 厦 蛇 奢 舌 仕
展	张 站 战 招 韩 赞 占 憾 粘 颤 詹 沾 斩 湛 绽
白	百 包 台 改 拜 败 哎 辈 摆 柏 芭 哀 罢 剥 栽
及	己 机 几 系 计 记 基 际 鸡 疾 圾 忌 稽 祭 棘
花	话 化 哈 或 华 画 划 获 汇 滑 瓜 徽 恢 哗 蛤
难	男 南 奶 颜 咱 惨 燃 摊 栏 呐 婉 谭 衍 旱 楠
节	界 姐 街 借 阶 届 洁 截 揭 捷 戒 皆 劫 羯 竭
联	连 简 练 恋 脸 链 炼 怜 莲 廉 辽 帘 敛 斓 镰
线	现 限 县 鲜 献 闲 仙 陷 羡 咁 咸 掀 衔 腺 馅
处	出 初 除 楚 础 触 储 撤 厨 丶 橱 雏 锄 捶 矗
术	数 书 熟 述 输 束 树 叔 暑 蔬 淑 抒 赎 薯 竖
此	次 词 急 笔 礼 击 材 刺 辞 圾 磁 慈 瓷 赐 茨
包	保 报 号 宝 抱 爆 暴 薄 逃 饱 堡 遥 剥 胞 曝
风	房 丰 封 峰 奋 疯 凤 锋 奉 缝 蜂 冯 逢 讽 纺
各	个 格 歌 哥 革 隔 割 戈 葛 鸽 阁 搁 菇 褐 噩
强	两 象 项 签 良 箱 抢 潜 枪 墙 腔 靓 呛 钳 蔷
选	宣 旋 悬 暅 炫 玄 轩 萱 喧 渲 绚 璇 嬛 眩 漩
技	己 机 几 系 计 记 基 际 鸡 疾 圾 忌 稽 祭 棘
写	些 解 谢 协 鞋 械 邪 谐 蟹 携 泄 蝎 歇 卸 胁
万	完 玩 晚 湾 弯 碗 挽 塆 丸 婉 顽 腕 榄 宛 皖
持	吃 处 裁 迟 池 尺 赤 痴 驰 齿 耻 斥 侈 翅 炽
清	情 请 亲 评 青 轻 庆 订 倾 晴 寝 卿 擎 氢 柠
宝	保 报 号 办 包 抱 爆 暴 薄 逃 饱 堡 遥 剥 胞
元	原 院 远 源 愿 园 缘 圆 怨 援 袁 苑 冤 渊 媛
色	格 科 社 额 似 河 刻 夜 核 舍 盒 瑟 禾 鹤 涩
走	周 楼 优 住 投 州 油 欧 奏 竹 诱 猴 兜 驻 抖
界	节 姐 街 借 阶 届 洁 截 揭 捷 戒 皆 劫 羯 竭
神	真 身 深 申 审 甚 沉 沈 伸 慎 肾 渗 绅 婶 莘
跟	任 各 干 份 根 赶 苯 阁 耕 嫩 搁 韧 壬 刃 棍
转	欢 专 展 装 传 环 赚 占 抓 幻 砖 唤 粘 撰 桓
片	变 先 见 便 健 签 篇 骗 偏 潜 兼 迁 践 淀 箭
向	想 相 像 形 象 项 响 香 享 乡 箱 详 凉 翔 祥
音	因 易 银 引 印 阴 隐 饮 姻 岩 淫 瘾 吟 殷 尹
卡	哈 科 亚 怕 苦 咯 咖 渴 壳 涯 腊 砸 祂 啪 慨
游	又 优 油 右 邮 尤 幼 忧 幽 悠 犹 诱 呦 佑 酉
质	知 直 至 指 支 置 止 织 纸 枝 脂 吱 肢 秩 挚
反	男 万 饭 范 翻 烦 犯 凡 繁 胆 返 泛 汗 番 帆
越	月 阅 页 悦 跃 岳 玥 渔 於 粤 曰 穴 逾 瑜 椰
导	到 道 宝 告 倒 跑 岛 刀 盗 诞 耗 腰 矛 炮 蹈
容	从 龙 融 荣 孔 恭 涌 桶 蓉 绒 溶 熔 陇 榕 冗
台	太 白 态 讨 嘅 奶 泰 胎 踏 呆 抬 歪 汰 惕 苔
南	男 难 奶 颜 咱 惨 燃 摊 栏 呐 婉 谭 衍 旱 楠
告	高 搞 猫 暴 泡 稿 糕 浩 恼 膏 镐 枣 糙 皋 羔
户	护 互 乎 湖 呼 胡 虎 忽 糊 狐 沪 壶 蝴 葫 弧
使	十 事 实 市 试 世 失 识 石 势 释 湿 饰 狮 尸
玩	完 万 晚 湾 坦 弯 碗 挽 塆 丸 婉 楠 顽 腕 宛
改	该 海 载 财 排 害 概 菜 盖 泰 鬼 奈 肝 矮 抬
类	位 丽 累 雷 泪 勒 赖 玫 啡 蕾 韦 磊 沸 莓 栗
装	长 创 状 赚 床 障 庄 妆 窗 爽 撞 壮 胀 霜 仗
张	长 装 伤 章 钟 掌 账 涨 障 挣 帐 丈 胀 倡 仗
值	知 直 至 指 支 置 止 织 纸 枝 脂 吱 肢 秩 挚
帮	榜 访 央 棒 洋 邦 绑 仰 苍 丧 纲 膀 磅 缸 枉
标	表 交 报 叫 效 料 挑 缴 漂 胞 屌 飙 彪 婊 逍
城	成 程 充 声 承 层 诚 盛 乘 郑 虫 挣 横 撑 呈
字	自 子 资 咨 仔 紫 姿 滋 兹 籽 淄 梓 疵 呲 渍
较	教 交 叫 角 脚 焦 胶 娇 骄 椒 矫 搅 蕉 浇 轿
运	员 云 孕 允 晕 韵 蕴 匀 熏 芸 酝 耘 陨 昀 熨
传	欢 专 展 转 装 环 赚 占 抓 幻 砖 唤 粘 撰 桓
星	行 性 像 形 型 病 兴 幸 醒 姓 刑 馨 秉 巷 杏
图	古 土 退 突 趣 途 吐 徒 兔 涂 吞 逾 芦 凸 醋
注	主 助 祝 筑 猪 逐 竹 驻 煮 丶 株 嘱 铸 诛 蛛
近	进 金 今 尽 检 坚 仅 紧 阴 津 禁 劲 斤 锦 谨
光	广 黄 狂 钢 冠 岗 逛 框 谎 灌 棺 惶 匡 潢 眶
确	去 月 觉 取 却 血 缺 雪 驱 悦 爵 粤 诀 茄 祛
由	又 优 油 右 邮 尤 幼 忧 幽 悠 犹 诱 呦 佑 酉
周	州 洲 筹 朱 诸 寿 兽 瘦 宙 舟 吼 骤 轴 咒 粥
失	十 事 实 市 试 世 使 识 石 势 释 湿 饰 狮 尸
边	变 线 片 编 荐 键 遍 辩 辨 贬 殿 勉 宪 煎 鞭
客	可 科 课 克 刻 颗 渴 壳 柯 阁 磕 棵 苛 坷 珂
精	经 京 境 景 竟 静 竞 镜 净 敬 睛 径 晶 颈 殑
朋	平 梦 丰 疯 碰 赠 捧 鹏 彭 棚 蹦 庚 蓬 膨 澎
英	应 影 营 迎 映 赢 盈 颖 婴 鹰 樱 莹 荧 萤 莺
息	西 喜 习 吸 媳 晰 稀 溪 夕 兮 茜 犀 烯 熄 嬉
广	光 黄 狂 冠 岗 逛 框 谎 灌 棺 匡 潢 眶 幌 胱
识	十 事 什 实 使 失 适 势 室 释 湿 饰 尸 拾 屎
华	话 化 哈 或 花 画 划 获 汇 滑 瓜 徽 恢 哗 蛤
楼	录 露 豆 陆 偶 透 漏 炉 喽 苟 陋 庐 搂 眸 娄
妈	吗 哪 达 马 模 码 巴 嘛 麻 骂 莫 冒 玛 扒 寞
调	表 教 条 脚 跳 挑 桥 描 胶 苗 辽 骄 礁 韬 硝
统	同 通 痛 童 腾 铜 筒 桶 讼 躺 桐 彤 瞳 耸 珑
始	十 事 什 实 使 失 识 适 势 室 释 湿 饰 尸 拾
观	关 管 官 软 馆 惯 冠 钻 贯 灌 莞 罐 棺 纶 竿
深	真 身 神 申 审 甚 沈 伸 慎 肾 渗 杉 绅 婶 莘
照	找 展 招 赵 炒 召 槽 诈 兆 罩 昭 爪 肇 拙 哨
亲	情 请 清 评 青 轻 另 庆 订 镜 倾 晴 寝 卿 擎
查	插 咋 扎 炸 渣 诈 柱 詹 挚 闸 榨 眨 乍 诧 栅
它	他 她 图 达 塔 踏 瓦 鸭 叭 爬 塌 祂 惕 咔 粑
立	理 里 力 利 历 礼 例 丽 励 莉 隶 哩 漓 犁 鲤
山	善 傻 删 闪 纱 扇 陕 擅 衫 罕 珊 杉 汕 姗 煽
准	注 镇 尊 针 圳 猪 逐 魂 朱 诸 诊 瞬 捉 蠢 贞
空	东 统 控 康 荣 恐 洞 孔 鸿 怂 棕 熔 酮 踊 炕
优	又 由 油 右 邮 尤 幼 忧 幽 悠 犹 诱 呦 佑 酉
班	办 玩 帮 版 半 般 板 伴 探 坛 搬 颁 斑 扮 塆
干	感 万 跟 敢 赶 残 甘 憾 杆 肝 尴 扳 赣 嫣 棺
取	去 区 曲 趣 趋 驱 屈 渠 棋 娶 瑜 躯 佢 乞 祛
达	大 打 答 搭 咯 督 丹 娜 塔 旦 敌 戴 玛 娃 胆
规	贵 归 鬼 柜 轨 毁 醉 跪 瑰 桂 闺 龟 硅 卦 崔
微	位 味 卫 谓 慰 伪 胃 薇 魏 韦 畏 惟 猥 萎 玮
演	验 严 延 炎 燕 盐 沿 掩 宴 咽 衍 彦 妍 腌 堰
必	比 笔 币 逼 避 彼 壁 碧 鄙 弊 辟 臂 蔽 屄 庇
至	知 直 指 支 置 止 织 纸 枝 脂 汁 吱 肢 秩 挚
易	艺 疑 遗 姨 疫 毅 椅 绎 夷 裔 沂 壹 倚 咦 屹
首	手 数 收 书 受 售 守 授 丑 寿 兽 瘦 鼠 署 宙
义	艺 疑 遗 姨 疫 毅 椅 绎 夷 裔 沂 壹 倚 咦 屹
店	点 电 段 限 典 蛋 牵 垫 歉 莲 廉 辨 颠 淀 殿
指	知 直 至 支 置 止 织 纸 枝 脂 汁 吱 肢 秩 挚
二	而 儿 哦 尔 恩 耳 饿 鹅 诶 饵 厄 遏 贰 娥 讹
医	艺 疑 遗 姨 疫 毅 椅 绎 夷 裔 沂 壹 倚 咦 屹
研	验 严 延 炎 燕 盐 沿 掩 宴 咽 衍 彦 妍 腌 堰
便	变 先 见 片 健 签 篇 骗 偏 潜 兼 迁 践 淀 箭
支	知 直 至 指 置 止 织 纸 枝 脂 汁 吱 肢 秩 挚
备	费 北 背 卫 悲 贝 违 辈 杯 倍 呗 碑 卑 佰 沛
京	经 精 境 景 竟 竞 镜 净 敬 睛 径 晶 颈 殑 荆
读	都 度 独 毒 督 堆 盾 裤 杜 赌 肚 渡 堵 妒 嘟
马	吗 哪 妈 达 模 码 巴 嘛 麻 骂 莫 冒 玛 扒 寞
在	再 海 孩 载 牌 罪 灾 胎 呆 碍 埃 欸 栽 宰 哉
具	车 据 剧 局 句 居 举 巨 聚 距 拒 俱 拘 矩 菊
款	选 元 观 远 况 段 宽 患 钻 媛 垮 桓 浣 鸳 漩
历	理 里 力 利 立 礼 例 丽 励 莉 隶 哩 漓 犁 鲤
育	于 语 愉 郁 羽 愚 狱 愈 寓 俞 吁 钰 禺 芋 煜
据	车 具 剧 局 句 居 举 巨 聚 距 拒 俱 拘 矩 菊
决	觉 据 剧 句 绝 举 掘 薛 爵 诀 崛 靴 抉 倔 厥
且	器 却 切 窃 伽 茄 妾 怯 惬 岐 榭 矜 沏 裘 酋
创	黄 川 床 窗 撞 凰 谎 霜 闯 喘 桩 敞 恍 疮 幢
言	验 严 延 炎 燕 盐 沿 掩 宴 咽 衍 彦 妍 腌 堰
示	十 事 什 实 使 失 识 适 石 势 室 释 饰 狮 尸
住	主 助 祝 筑 猪 逐 竹 驻 煮 丶 株 嘱 铸 诛 蛛
站	展 战 招 韩 占 诊 宅 粘 颤 詹 沾 斩 湛 绽 栈
推	退 汇 托 途 腿 抬 锐 讳 癸 蹄 涕 颓 蜕 盔 嚏
企	其 期 七 气 器 妻 旗 戚 棋 凄 祁 麒 迄 杞 祺
条	表 教 调 跳 挑 桥 描 胶 苗 辽 骄 礁 韬 硝 窍
投	头 游 楼 土 突 搜 透 偷 奏 吐 兔 逗 痘 剖 牟
谁	市 使 失 识 示 黑 石 史 施 摄 狮 沈 晒 伸 慎
博	播 波 鼻 伯 拨 玻 卜 勃 沫 搏 坝 泊 驳 脖 渤
整	正 证 政 终 争 征 郑 症 挣 赠 肿 衷 蒸 拯 睁
超	操 朝 潮 毫 炒 拆 吵 抄 叉 嘲 巢 嚎 爪 钞 皓
份	分 认 飞 粉 凡 奋 纷 喷 泛 笨 纹 氛 愤 芬 逢
存	错 参 村 滚 催 寸 裙 崔 醋 蕴 摧 钧 臀 篡 遁
集	己 机 几 系 计 记 基 际 鸡 疾 圾 忌 稽 祭 棘
职	知 直 至 指 支 置 止 织 纸 枝 脂 旨 吱 肢 秩
许	需 续 须 序 虚 绪 徐 蓄 叙 旭 畜 絮 恤 婿 钨
希	西 喜 习 吸 媳 晰 稀 溪 夕 兮 茜 犀 烯 嬉 羲
剧	车 具 据 局 居 巨 聚 距 拒 俱 拘 矩 菊 焗 橘
球	求 牛 秋 齐 纠 秦 仇 丘 邱 囚 谬 糗 矜 裘 酋
满	男 范 慢 漫 兰 蛮 曼 埋 迈 谭 衍 茂 瞒 蔓 喃
营	应 影 英 迎 硬 映 盈 颖 婴 鹰 樱 莹 荧 萤 莺
版	办 玩 帮 班 半 般 板 伴 探 坛 搬 颁 斑 扮 塆
福	服 付 父 富 府 附 妇 幅 肤 辅 傅 抚 弗 辐 缚
货	活 或 火 获 昨 伙 拖 魂 扩 惑 霍 祸 豁 壕 灬
州	主 手 候 周 洲 守 宙 舟 骤 轴 丶 咒 粥 皱 蛛
晚	完 万 玩 湾 弯 碗 挽 塆 丸 婉 楠 顽 腕 宛 皖
课	可 科 客 克 苦 刻 颗 渴 壳 柯 磕 棵 苛 坷 珂
离	理 里 力 利 立 历 礼 例 丽 励 莉 隶 哩 漓 犁
笑	小 先 消 销 效 跳 晓 孝 肖 萧 削 宵 潇 嚣 霄
死	四 司 思 斯 食 激 似 丝 私 撕 寺 肆 饲 畸 嘶
眼	验 严 延 炎 燕 盐 沿 掩 宴 咽 衍 彦 妍 腌 堰
股	故 古 顾 估 鼓 固 骨 孤 姑 谷 雇 辜 菇 咕 箍
议	艺 疑 遗 姨 疫 毅 椅 绎 夷 裔 沂 壹 倚 咦 屹
领	零 轻 另 灵 令 龄 凌 玲 铃 陵 岭 菱 聆 伶 拎
权	全 券 幻 缘 圆 潜 迁 患 泉 劝 拳 悬 谦 锻 犬
早	造 遭 腰 矛 糕 扫 槽 糟 躁 澡 罩 燥 枣 皂 噪
银	因 音 引 印 阴 隐 饮 姻 淫 瘾 吟 殷 尹 茵 荫
低	地 第 底 弟 递 帝 滴 迪 抵 敌 蒂 堤 笛 旳 缔
形	行 性 请 星 型 病 兴 幸 醒 姓 刑 馨 荆 萍 秉
步	不 部 补 布 币 逼 巨 捕 怖 卜 埠 簿 哺 惚 卟
案	安 男 反 阿 按 暗 寒 傲 岸 燕 俺 氨 鞍 敖 晏
造	早 遭 腰 矛 糕 扫 槽 糟 躁 澡 罩 燥 枣 皂 噪
远	原 院 元 源 愿 园 缘 圆 怨 援 袁 苑 冤 渊 媛
够	楼 购 构 狗 偷 固 尤 沟 姑 犹 勾 钩 苟 搂 釉
参	言 晚 眼 案 餐 湾 残 惨 堪 埋 俺 岩 碗 苍 灿
刚	房 港 访 央 棒 钢 岗 杭 仰 纲 杠 旸 纺 庞 缸
组	足 护 父 座 普 遇 族 租 谷 绪 捕 珠 祖 阻 喻
婚	户 运 华 准 伦 混 幻 呼 魂 遵 浑 昏 仑 焕 葫
功	工 公 共 供 综 攻 宫 贡 恭 筒 桶 讼 轰 巩 弓
型	行 性 请 星 形 病 兴 幸 醒 姓 刑 馨 鹰 荆 萍
战	展 站 招 韩 占 宅 憾 粘 颤 詹 沾 斩 湛 绽 栈
象	想 性 相 像 向 项 讲 响 香 享 乡 箱 详 熊 翔
况	广 款 黄 狂 抗 矿 荒 框 凰 煌 旷 惶 匡 簧 潢
段	观 店 款 断 短 端 泉 诞 援 旋 贯 劝 垫 拳 锻
王	网 望 玩 帮 往 忘 亡 旁 汤 仿 荡 旺 汪 妄 葬
项	想 性 相 像 向 象 讲 响 香 享 乡 箱 详 熊 翔
团	原 院 算 券 幻 缘 圆 贪 拳 猿 垣 绚 町 痪 痊
消	小 笑 销 效 跳 晓 贤 孝 肖 萧 削 宵 潇 嚣 霄
限	现 先 险 县 鲜 献 闲 仙 陷 嫌 羡 宪 咸 掀 衔
连	联 简 练 恋 脸 链 炼 怜 莲 廉 辽 羡 帘 敛 斓
拿	那 哪 哈 码 亚 怕 纳 罚 娜 涯 哒 呐 匿 噶 趴
士	事 什 实 市 使 失 识 适 势 室 释 饰 狮 尸 拾
差	啥 察 沙 茶 插 储 池 尺 叉 耻 巢 蛤 橱 岔 茬
究	就 九 价 酒 久 救 旧 巨 纠 捷 戒 忌 舅 揪 玖
热	入 特 认 格 科 呢 额 野 页 液 惹 鸽 阁 鹅 瑟
销	小 笑 消 效 跳 晓 贤 孝 肖 萧 削 宵 潇 嚣 霄
您	民 念 宁 辛 妮 锦 秦 芯 筋 昵 楠 碾 沁 廿 殡
未	维 委 味 威 谓 尾 慰 喂 胃 薇 魏 畏 惟 潍 猥
待	代 带 导 改 嘚 贷 哎 搭 戴 呆 袋 哀 栽 歹 黛
验	严 延 炎 燕 盐 沿 岩 掩 宴 咽 衍 彦 妍 腌 堰
续	需 许 须 序 附 虚 绪 徐 蓄 叙 旭 畜 絮 恤 婿
千	前 签 潜 迁 牵 歉 谦 遣 铅 乾 倩 嵌 谴 黔 钳
局	车 具 据 剧 句 居 举 巨 聚 距 俱 拘 矩 菊 橘
队	对 随 鬼 嘴 滴 堆 醉 兑 堵 堤 笛 崔 怼 逮 惰
半	办 玩 帮 班 版 般 板 伴 探 坛 搬 颁 斑 扮 疤
卖	买 才 太 满 概 采 裁 赖 冒 凯 麦 煤 矛 埋 迈
源	原 院 元 远 愿 园 缘 圆 怨 援 袁 苑 冤 媛 猿
讲	将 京 简 江 奖 降 镜 辆 谅 疆 姜 酱 囧 蒋 僵
根	更 跟 干 敢 闻 革 仁 隔 纷 氛 狠 嫩 粪 焚 摁
命	明 名 迎 净 丁 鸣 铭 殑 冥 擎 璟 柠 檬 茗 泠
票	教 条 挑 缴 漂 胶 朴 飘 萧 搅 嫖 僚 侥 筱 瓢
油	又 由 优 右 邮 尤 幼 忧 幽 悠 犹 诱 呦 佑 酉
态	太 白 台 讨 嘅 奶 泰 胎 踏 呆 抬 歪 汰 惕 苔
换	欢 环 幻 患 缓 泉 涵 汗 唤 焕 桓 痪 寰 浣 宦
际	计 级 及 集 即 急 吉 既 剂 肌 寂 挤 脊 羁 藉
简	间 件 检 坚 健 渐 剑 兼 践 尖 舰 奸 贱 煎 碱
济	计 级 及 集 即 急 吉 既 剂 肌 寂 挤 脊 羁 藉
评	平 轻 兴 迎 聘 凭 瓶 苹 旁 萍 坪 擎 蓬 乒 聆
底	地 第 低 弟 递 帝 滴 迪 抵 敌 蒂 堤 笛 旳 缔
器	期 七 气 妻 戚 棋 凄 祁 麒 迄 杞 祺 亟 岐 沏
却	去 月 觉 区 确 取 血 缺 雪 驱 悦 爵 粤 崛 茄
般	办 玩 帮 班 版 半 板 伴 探 坛 搬 颁 斑 扮 疤
充	城 冲 乘 昌 尝 崇 忠 虫 宠 呈 洪 轰 秤 倡 弘
声	生 正 省 承 争 升 胜 圣 剩 呈 蒸 昇 牲 绳 甸
青	情 请 清 亲 评 轻 另 庆 订 镜 倾 鸣 晴 岭 寝
红	送 恐 冬 宗 宏 洪 虹 泳 鸿 涌 葱 筒 桶 轰 哄
补	不 部 步 布 币 逼 巨 捕 怖 卜 埠 簿 哺 惚 卟
戏	西 喜 习 吸 媳 晰 稀 溪 夕 兮 茜 犀 烯 嬉 羲
养	样 望 阳 党 杨 央 洋 扬 羊 仰 狼 氧 旸 痒 烊
叫	教 校 较 脚 缴 焦 胶 娇 椒 郊 矫 搅 蕉 浇 饺
共	工 公 功 供 攻 宫 贡 恭 筒 讼 轰 栋 丛 巩 弓
火	活 或 货 获 昨 伙 拖 魂 扩 惑 霍 祸 豁 壕 灬
购	够 故 构 古 狗 骨 沟 勾 喽 酉 喉 钩 苟 疣 逅
效	小 先 笑 消 销 跳 晓 孝 肖 萧 削 宵 潇 嚣 霄
毕	比 笔 逼 避 鼻 彼 壁 碧 鄙 弊 辟 臂 蔽 毙 庇
阳	样 养 杨 央 洋 扬 羊 仰 脏 艳 氧 旸 痒 烊 秧
往	网 让 望 玩 帮 王 忘 亡 旁 汤 仿 荡 旺 汪 妄
哥	个 特 格 科 歌 各 革 隔 割 戈 葛 鸽 阁 鹅 搁
料	聊 疗 跳 缴 莲 辽 撩 饺 帘 寥 廖 僚 缪 狡 缭
初	出 处 除 楚 础 触 储 撤 厨 丶 橱 雏 锄 炊 孰
唱	场 常 章 厂 偿 昌 尝 畅 撑 肠 倡 惩 敞 殇 漳
答	大 打 达 搭 滴 骂 咯 督 娜 塔 旦 敌 戴 玛 娃
布	不 部 步 补 币 逼 毒 巨 捕 怖 卜 埠 簿 哺 惚
假	家 加 价 佳 架 驾 甲 嘉 嫁 锦 夹 贾 迦 钾 戛
助	注 祝 筑 猪 逐 珠 诸 驻 煮 丶 株 嘱 铸 诛 蛛
送	红 共 供 融 松 宋 泳 讼 轰 诵 颂 雍 嵩 怂 耸
江	将 京 讲 简 奖 降 乡 镜 辆 谅 疆 姜 酱 囧 蒋
留	六 流 历 刘 漏 裂 黎 柳 浏 溜 瘤 榴 陋 硫 琉
省	生 正 声 承 争 升 胜 圣 剩 呈 蒸 昇 牲 绳 甸
环	欢 换 幻 患 缓 泉 涵 汗 唤 焕 桓 痪 寰 浣 宦
母	目 努 府 密 舞 木 陆 幕 慕 姆 牧 墓 募 瑜 穆
除	出 吃 处 初 楚 础 触 储 撤 厨 丶 橱 雏 锄 炊
约	要 药 摇 邀 腰 妖 炮 耀 陶 遥 咬 谣 岆 瑶 姚
载	在 再 海 孩 牌 罪 灾 胎 植 碍 埃 欸 栽 宰 哉
伤	上 长 商 张 山 双 章 升 尚 赏 障 昇 胀 甸 嗓
险	现 限 县 鲜 献 闲 仙 陷 嫌 羡 咁 宪 咸 掀 衔
故	股 古 顾 估 鼓 固 骨 孤 姑 谷 雇 辜 菇 咕 沽
诉	局 速 素 熟 舞 苏 宿 俗 趋 塑 腹 肃 溯 暮 饲
拉	马 历 离 啦 俩 垃 辣 塌 璃 唻 叻 梨 蜡 腊 喇
牌	白 排 拍 嘅 奶 派 胎 胖 迫 抬 拌 钙 趴 耙 佰
修	求 流 续 戏 秀 休 侠 羞 柳 蓄 夕 霞 袖 绣 斜
艺	意 已 衣 益 依 异 疑 忆 亿 译 翼 谊 椅 溢 怡
随	岁 施 赛 虽 室 税 贵 素 退 丝 私 诗 碎 髓 遂
病	并 清 帮 星 精 灵 冰 兵 屏 赢 刑 饼 丙 秉 菱
哦	额 恶 俄 呃 饿 鹅 噩 厄 鄂 遏 娥 讹 扼 胺 峨
阿	啊 按 码 亚 怕 爸 呀 额 巴 压 芽 讶 哑 靶 敖
斯	四 司 思 死 食 激 似 丝 私 撕 寺 肆 饲 畸 嘶
脑	男 豪 诺 闹 糕 浩 妖 炮 桃 槽 恼 捞 姚 挠 灶
显	现 限 县 鲜 献 闲 仙 陷 嫌 羡 咁 宪 咸 掀 衔
财	才 带 吃 白 此 持 彩 材 采 菜 哎 裁 猜 欸 挨
极	计 级 及 集 即 急 吉 既 剂 肌 寂 挤 脊 羁 藉
画	话 化 哈 或 花 华 划 获 汇 滑 瓜 徽 恢 哗 蛤
尔	二 而 儿 哦 恶 恩 耳 饿 饵 噩 厄 遏 贰 迩 胺
供	工 公 功 共 综 攻 宫 贡 恭 筒 桶 讼 轰 巩 弓
付	福 负 富 夫 副 符 幅 肤 傅 伏 覆 赋 赴 辐 缚
配	北 黑 培 围 妹 皮 悲 陪 赔 煤 佩 蔚 昧 巍 沛
模	默 魔 末 摩 莫 磨 摸 膜 墨 陌 脉 寞 抹 漠 沫
适	十 事 什 实 市 试 失 识 士 势 室 湿 饰 狮 尸
但	单 待 验 担 蛋 淡 丹 旦 胆 诞 耽 叨 拌 氮 郸
终	中 种 重 众 章 钟 障 忠 虫 帐 虹 仲 肿 衷 筝
啦	马 历 离 拉 俩 垃 辣 塌 璃 唻 叻 梨 蜡 腊 喇
否	走 游 由 楼 优 够 腐 扶 傅 谋 伏 覆 勾 凑 赋
则	客 课 责 紫 液 泽 磕 冶 棵 褐 啧 厄 苛 孜 仄
黑	内 非 培 谓 嘿 悔 啡 胃 磊 畏 禾 咳 嗨 鹤 惟
断	观 店 款 段 短 端 泉 诞 援 旋 贯 劝 垫 拳 锻
责	客 课 则 紫 液 泽 磕 冶 棵 褐 啧 厄 苛 孜 仄
策	色 客 热 测 册 侧 厕 促 彻 涩 椰 醋 赐 磕 冶
治	知 直 至 指 支 置 止 织 纸 枝 脂 吱 肢 秩 挚
足	组 护 父 座 普 遇 族 租 谷 绪 捕 珠 祖 阻 喻
愿	原 院 元 远 源 园 缘 圆 怨 援 袁 苑 冤 渊 媛
句	车 具 据 剧 局 居 举 巨 聚 距 俱 拘 矩 菊 焗
排	白 牌 拍 嘅 奶 派 胎 胖 迫 抬 拌 钙 趴 耙 佰
即	计 级 及 技 集 积 急 激 继 吉 辑 既 剂 肌 挤
词	次 此 奇 笔 益 依 礼 刺 辞 唉 磁 慈 瓷 赐 茨
板	办 反 玩 帮 班 版 半 般 伴 探 坛 搬 颁 斑 扮
称	身 程 陈 沉 晨 尘 狠 辰 臣 慎 趁 衬 阐 贞 疹
境	经 精 京 警 竟 静 竞 镜 敬 睛 径 晶 颈 殑 荆
置	知 直 至 指 支 止 织 纸 枝 脂 汁 旨 肢 秩 挚
军	运 近 仅 均 寻 巨 君 俊 晕 循 菌 骏 狙 峻 钧
念	年 变 先 男 见 甜 剑 潜 兼 迁 践 贱 淀 黏 碾
拍	白 牌 排 嘅 奶 派 胎 胖 迫 抬 拌 钙 趴 耙 佰
属	数 术 熟 述 输 束 叔 殊 暑 鼠 署 疏 蔬 淑 抒
招	找 展 照 赵 炒 召 槽 诈 兆 罩 昭 爪 肇 拙 哨
按	安 男 案 翻 暗 岸 燕 俺 氨 鞍 顽 敖 绊 晏 摁
引	因 音 银 印 阴 隐 饮 姻 淫 瘾 吟 殷 尹 芸 茵
切	且 器 却 窃 伽 茄 妾 怯 蔑 惬 矜 沏 裘 酋 蹊
春	楚 纯 础 触 魂 瞬 辰 臣 趁 蠢 垂 唇 戳 馋 醇
码	吗 妈 马 亚 怕 米 爸 嘛 麻 猫 骂 玛 涯 祂 啪
轻	情 请 清 亲 评 青 另 庆 订 兵 倾 晴 岭 寝 卿
众	中 种 重 终 争 钟 宗 郑 症 崇 忠 洪 纵 仲 肿
兴	行 性 星 形 型 病 幸 醒 姓 刑 馨 鑫 荆 秉 杏
酒	就 九 基 究 极 久 救 旧 纠 舅 揪 玖 韭 灸 疚
录	路 陆 绿 鲁 鹿 卢 碌 撸 芦 璐 卤 庐 禄 泸 虏
呵	和 合 呢 设 何 则 河 核 喝 盒 荷 吓 赫 贺 禾
划	话 化 花 华 换 画 乎 滑 辉 缓 霍 刮 哗 讳 焕
速	诉 素 熟 舞 苏 宿 俗 趋 塑 腹 肃 卢 溯 暮 稣
独	都 度 读 毒 督 堆 盾 吐 裤 杜 赌 肚 渡 堵 妒
克	可 科 客 课 刻 颗 渴 壳 柯 磕 棵 苛 坷 珂 嗝
绝	觉 决 届 皆 掘 爵 诀 崛 峻 抉 睫 郡 倔 厥 獗
石	十 事 什 实 市 试 失 识 士 适 势 室 释 饰 狮
角	教 交 叫 脚 缴 焦 胶 娇 骄 郊 矫 蕉 浇 轿 嚼
细	西 喜 习 吸 媳 晰 稀 溪 夕 兮 茜 犀 烯 熄 嬉
曲	去 区 取 组 趣 顾 趋 驱 屈 渠 棋 娶 躯 佢 祛
久	就 九 基 究 极 酒 救 旧 纠 舅 揪 玖 韭 灸 疚
双	装 伤 尚 床 赏 皇 妆 爽 凰 谎 慌 霜 疮 幢 惶
嗯	那 女 哪 拿 尼 娜 泥 逆 怒 妮 腻 奴 伱 倪 霓
套	讨 岛 淘 逃 桃 陶 涛 萄 佬 掏 韬 褒 滔 绸 挞
护	户 互 乎 湖 呼 胡 虎 忽 糊 狐 沪 壶 蝴 葫 弧
岁	随 施 赛 虽 室 税 贵 素 退 丝 私 诗 碎 髓 遂
姐	接 节 界 街 借 届 洁 截 揭 捷 戒 皆 羯 桔 芥
父	福 付 负 富 夫 副 符 幅 肤 傅 伏 覆 赴 辐 缚
食	四 司 思 死 斯 激 似 丝 私 撕 寺 肆 饲 嘶 厮
维	未 委 味 威 谓 尾 慰 喂 胃 薇 魏 畏 惟 潍 猥
害	还 哈 海 号 孩 择 毫 艾 嘿 哀 晒 宅 咳 罕 歹
座	作 做 或 左 坐 昨 著 佐 琢 撮 拙 驼 灼 灬 浊
响	想 相 像 向 形 象 项 香 享 乡 箱 详 梁 凉 翔
择	海 找 值 债 炸 宅 芝 摘 寨 咳 肢 沾 窄 肇 缀
势	十 事 什 实 市 失 识 士 适 室 释 饰 尸 拾 屎
预	于 语 育 愉 郁 羽 愚 狱 愈 寓 俞 吁 钰 禺 芋
梦	等 忙 丰 盟 蒙 萌 横 猛 缝 蜂 孟 逢 耕 耿 懵
李	理 里 力 利 立 礼 例 丽 励 莉 隶 哩 漓 犁 鲤
他	她 图 妈 它 达 马 塔 踏 瓦 鸭 叭 爬 塌 祂 惕
幸	行 性 请 星 形 型 兴 醒 姓 刑 馨 荆 萍 秉 巷
普	布 固 铺 谱 扑 浦 娶 披 裕 葡 菩 埔 仆 蒲 噗
构	够 购 故 古 狗 骨 沟 孤 勾 喽 酉 喉 钩 苟 疣
获	活 或 货 火 伙 拖 魂 扩 桌 惑 霍 祸 豁 昊 剁
奇	起 其 七 汽 弃 妻 旗 骑 棋 契 岂 祈 琦 凄 砌
飞	内 费 非 份 肥 菲 废 啡 肺 妃 匪 沸 绯 酚 翡
测	色 客 热 策 册 侧 厕 促 彻 涩 椰 醋 赐 磕 冶
某	目 构 幼 奏 忧 谋 侯 募 沫 麽 牟 眸 垢 鸥 蔻
黄	幻 皇 妆 患 荒 凰 唤 谎 慌 煌 晃 恍 桓 惶 簧
遇	于 语 育 愉 郁 羽 愚 狱 愈 寓 俞 吁 钰 禺 芋
移	意 已 衣 益 依 异 疑 忆 亿 译 翼 谊 椅 溢 怡
亚	呀 压 雅 牙 押 涯 鸭 叭 丫 吖 芽 讶 哑 幺 鸦
志	知 直 至 指 支 职 置 止 织 纸 枝 脂 肢 秩 挚
林	留 李 尽 临 邻 琳 淋 赁 澜 菱 榴 吟 彬 沦 麟
农	宁 童 拥 松 弄 隆 浓 贡 佣 匆 栋 丛 垄 巩 彤
怕	妈 它 达 马 跑 牙 扒 鸭 叭 爬 啪 葩 帕 趴 蒲
增	总 政 风 梦 曾 宗 盟 疼 蒙 郑 疯 赠 逢 彭 耕
史	十 事 实 市 试 使 失 识 士 石 势 释 湿 饰 狮
三	山 班 干 演 含 散 犯 懒 诞 潘 宴 叛 咽 伞 绊
景	经 精 京 境 警 竟 静 竞 镜 净 敬 睛 径 晶 殑
律	乐 离 率 旅 虑 肋 鹿 侣 粒 履 吕 滤 驴 铝 屡
率	乐 离 律 旅 虑 肋 鹿 侣 粒 履 吕 滤 驴 铝 屡
懂	动 通 东 空 灯 勇 冬 洞 董 纵 冻 筒 栋 澄 蓉
群	论 确 取 趣 询 缺 勤 盾 滚 巡 敦 裙 旬 熏 芸
园	原 院 元 远 愿 缘 圆 怨 援 袁 苑 冤 渊 媛 猿
承	成 程 城 充 诚 盛 乘 昌 撑 呈 肠 秤 惩 甸 敞
委	未 维 味 威 谓 尾 慰 喂 胃 薇 魏 畏 惟 潍 猥
饭	万 反 范 翻 烦 犯 凡 繁 胆 返 泛 番 帆 贩 瞒
积	己 机 几 系 计 及 技 集 即 纪 继 鸡 剂 寂 挤
苦	股 步 组 库 符 哭 酷 裤 惧 赋 浴 枯 缚 埔 溯
衣	意 已 义 医 移 忆 仪 伊 谊 疫 毅 椅 溢 怡 颐
章	长 重 张 终 厂 掌 账 涨 障 帐 丈 胀 仗 颤 彰
售	手 收 书 受 术 首 守 授 丑 寿 兽 瘦 臭 舟 吼
致	知 直 至 指 支 职 置 止 织 纸 枝 脂 旨 肢 秩
盘	谈 范 慢 频 判 胖 盼 潘 叛 攀 贩 炭 滥 婉 帕
彩	才 带 吃 白 此 持 财 材 采 菜 哎 裁 猜 欸 挨
施	什 实 市 师 试 世 视 式 使 失 识 示 士 适 饰
赛	台 使 改 失 识 始 派 拜 塞 碎 唉 歪 踩 霾 歹
米	依 密 迷 秘 蜜 弥 咪 谜 幂 泌 靡 觅 犁 羁 眯
短	观 店 款 远 段 源 断 端 援 旋 贯 劝 垫 拳 锻
爸	吧 八 把 办 步 拿 呀 笔 巴 拔 擦 芭 罢 叭 疤
虽	随 岁 施 赛 室 税 贵 素 退 丝 私 诗 碎 髓 遂
尽	进 金 今 近 银 仅 紧 津 禁 劲 斤 锦 谨 晋 巾
急	己 机 几 系 计 及 技 集 即 纪 继 鸡 剂 寂 挤
呀	亚 压 雅 牙 摇 押 涯 鸭 谣 丫 吖 芽 讶 哑 鸦
播	博 波 逼 鼻 伯 拨 玻 卜 勃 搏 坝 泊 驳 脖 渤
编	建 变 边 连 简 遍 辩 辨 奸 贬 淀 鞭 奠 绊 帘
负	福 付 富 府 夫 妇 副 幅 肤 傅 伏 覆 赋 赴 辐
争	正 证 政 整 征 郑 症 挣 振 肿 衷 蒸 拯 睁 筝
升	生 程 整 声 省 申 胜 圣 症 剩 哼 呈 昇 牲 绳
落	路 罗 洛 逻 裸 啰 萝 螺 囖 撸 璐 卤 噜 烙 骆
互	户 护 乎 湖 呼 胡 虎 忽 糊 狐 沪 壶 蝴 葫 弧
村	论 错 运 存 困 均 寻 惨 催 寸 循 搓 摧 淳 陨
谈	眼 弹 探 湾 蓝 坛 坦 摊 贪 叹 埋 俺 碳 滩 炭
药	要 约 摇 邀 腰 妖 耀 饱 遥 咬 谣 岆 瑶 姚 钥
龙	通 东 统 空 融 灵 宫 隆 桶 岭 笼 垄 拢 珑 聋
须	需 许 续 序 虚 绪 徐 蓄 叙 旭 畜 絮 恤 婿 钨
笔	比 毕 币 逼 避 闭 彼 壁 碧 鄙 弊 辟 臂 屄 痹
范	男 房 反 饭 翻 烦 犯 凡 繁 返 泛 番 帆 贩 瞒
检	间 件 简 坚 健 渐 剑 兼 践 尖 舰 奸 贱 煎 碱
益	意 已 义 医 移 忆 仪 伊 谊 疫 毅 椅 溢 怡 颐
坚	间 件 简 检 健 渐 剑 兼 践 尖 舰 奸 贱 煎 碱
官	关 管 原 观 馆 惯 冠 贯 灌 莞 罐 棺 纶 竿 眷
香	想 相 像 向 形 象 项 响 享 乡 箱 详 梁 翔 祥
居	车 具 据 剧 局 句 举 巨 聚 距 俱 拘 矩 菊 焗
室	什 实 市 师 试 世 视 式 使 失 识 示 士 适 饰
慢	男 满 谈 范 漫 湾 蛮 曼 番 埋 迈 谭 衍 茂 瞒
永	用 营 拥 勇 赢 洞 庸 泳 涌 佣 咏 雍 棕 甬 踊
频	品 片 音 尽 临 拼 贫 淋 潘 匹 鑫 叛 钦 擒 坯
额	哦 恶 俄 呃 饿 鹅 噩 厄 鄂 遏 娥 讹 扼 胺 峨
富	福 付 负 府 夫 妇 副 幅 肤 傅 伏 覆 赋 赴 辐
挺	听 清 统 亲 景 停 庭 童 醒 厅 兵 堂 颖 婷 亭
介	节 界 姐 街 借 届 洁 截 揭 捷 戒 皆 羯 桔 芥
税	说 水 书 试 世 视 式 术 睡 束 树 湿 挥 饰 狮
背	费 北 备 卫 悲 贝 违 辈 杯 倍 呗 碑 卑 薇 佰
另	零 并 领 灵 令 龄 凌 玲 铃 陵 岭 菱 聆 伶 拎
依	意 已 义 医 移 忆 仪 伊 谊 疫 毅 椅 溢 怡 颐
贵	规 归 鬼 柜 轨 徽 醉 跪 瑰 桂 闺 龟 硅 崔 诡
礼	理 里 力 利 立 例 丽 励 莉 隶 哩 漓 犁 鲤 珞
享	想 相 像 向 象 项 响 香 乡 箱 详 凉 翔 祥 贤
免	面 先 见 健 敏 兼 践 眠 棉 淀 箭 绵 勉 缅 辫
味	位 微 卫 谓 慰 伪 胃 薇 魏 韦 畏 惟 猥 萎 玮
素	局 诉 速 熟 舞 苏 宿 俗 趋 塑 狱 腹 肃 溯 暮
击	己 机 几 系 计 及 技 集 即 纪 继 鸡 剂 寂 挤
材	才 带 吃 白 此 持 财 彩 采 菜 哎 裁 猜 欸 挨
巴	吧 八 把 报 哈 爸 呀 避 娃 拔 芭 罢 叭 疤 搏
肯	任 客 温 恩 困 稳 忍 仁 刊 壳 昆 愤 吻 堪 坎
大	打 达 答 搭 抵 罚 娜 塔 旦 敌 戴 玛 娃 胆 挖
块	开 快 跨 凯 亏 夸 乖 葵 垮 楷 窥 筷 匮 胯 傀
压	亚 呀 雅 牙 押 涯 鸭 丫 吖 芽 讶 哑 鸦 崖 娅
古	股 故 顾 估 鼓 固 骨 孤 姑 谷 雇 菇 咕 沽 箍
激	己 机 几 系 计 及 技 集 即 纪 继 鸡 剂 寂 挤
似	四 司 思 死 斯 食 丝 私 肌 撕 寺 肆 饲 嘶 厮
申	身 设 神 深 审 甚 珍 剩 沈 伸 慎 肾 渗 绅 婶
河	和 合 呢 设 何 德 则 呵 核 喝 盒 荷 吓 赫 贺
智	之 知 直 制 质 职 置 志 止 织 纸 址 枝 旨 秩
刻	可 科 客 课 则 克 颗 渴 壳 柯 磕 棵 苛 坷 珂
仅	进 金 今 近 银 尽 紧 津 禁 劲 斤 锦 谨 晋 巾
训	论 询 寻 讯 迅 循 巡 逊 旬 勋 熏 驯 薰 歆 陨
睡	说 水 书 试 世 视 式 术 税 束 树 湿 挥 饰 狮
嘚	代 带 改 待 贷 搭 戴 呆 袋 哀 栽 歹 黛 暧 逮
穿	换 川 船 患 窗 缓 串 缠 唇 馋 喘 醇 栓 忏 篡
陈	称 甚 沉 晨 扯 阵 尘 诊 辰 臣 趁 衬 秤 铲 绅
异	意 已 义 医 移 忆 仪 伊 谊 疫 毅 椅 溢 怡 颐
航	放 房 望 扬 杭 洪 憾 挡 葬 晃 傍 漳 簧 彷 吭
夜	也 业 爷 野 页 叶 液 泽 耶 曰 椰 冶 噎 矣 讹
旅	乐 离 律 率 虑 鲁 肋 鹿 侣 粒 履 吕 滤 驴 铝
亮	两 量 香 良 降 辆 梁 凉 粮 狼 玲 谅 疆 浆 靓
培	位 被 配 威 陪 赔 倍 废 佩 玫 韦 匹 匪 惟 沛
担	但 单 导 蛋 淡 丹 旦 胆 诞 侃 捣 丸 耽 氮 郸
午	五 无 物 武 舞 误 吴 悟 伍 雾 呜 坞 芜 梧 捂
络	老 报 倒 跑 劳 闹 赖 矛 篮 牢 捞 姥 佬 拦 唠
健	间 件 简 检 坚 渐 剑 兼 践 尖 舰 奸 贱 煎 碱
控	通 空 痛 攻 恐 孔 贡 铜 踪 涌 哄 溶 扛 彤 拢
搞	高 告 暴 稿 糕 浩 恼 膏 佬 镐 枣 凿 糙 皋 羔
温	文 问 微 卫 粉 闻 稳 纷 纹 吻 畏 挽 雯 蚊 潍
曾	总 政 风 梦 增 仍 宗 盟 疼 蒙 郑 疯 赠 逢 彭
例	理 里 力 利 立 礼 丽 励 莉 隶 哩 漓 犁 鲤 珞
概	该 海 改 载 财 排 菜 盖 泰 鬼 奈 矮 抬 尬 嘎
签	前 钱 潜 迁 欠 牵 歉 谦 遣 铅 乾 倩 嵌 谴 钳
采	才 带 吃 白 此 持 财 彩 材 菜 哎 裁 猜 欸 挨
核	和 合 呢 设 何 歌 呵 河 喝 虎 盒 荷 吓 赫 贺
破	婆 默 魔 霸 坡 陌 脉 颇 泼 蜗 趴 菩 珀 陂 坯
云	员 运 存 孕 允 晕 韵 蕴 匀 媛 芸 酝 耘 陨 昀
防	方 放 房 访 亡 糖 繁 旁 凤 汤 仿 芳 坊 妨 纺
努	付 足 句 屋 欲 促 距 幅 督 怒 豫 拘 喻 奴 侮
层	等 更 从 增 承 冷 仍 盛 疼 聪 奉 孟 蚌 橙 澄
啥	社 术 查 示 杀 沙 傻 狮 烧 叔 删 厦 纱 莎 舌
府	福 付 负 富 夫 妇 副 符 幅 肤 傅 伏 覆 赋 赴
密	米 依 迷 秘 蜜 姨 弥 咪 谜 幂 泌 靡 孜 觅 眯
列	留 烈 裂 猎 劣 咧 膊 磷 偕 秸 丿 镍 遴 砾 拮
软	券 幻 缘 圆 卷 润 冠 酸 染 患 缓 怨 泉 旋 贯
丽	理 里 力 利 立 礼 例 励 莉 隶 哩 漓 犁 鲤 珞
册	色 客 热 策 测 侧 厕 促 涩 椰 醋 赐 磕 冶 棵
乎	户 护 互 湖 呼 胡 虎 忽 糊 狐 沪 壶 蝴 葫 弧
惠	回 汇 挥 慧 灰 悔 辉 徽 毁 绘 恢 贿 讳 卉 晖
追	至 指 致 汇 珠 慧 朱 徽 毁 恢 坠 椎 缀 斋 赘
警	经 精 京 境 景 竟 竞 镜 净 敬 睛 径 晶 颈 殑
党	当 帮 档 丁 扬 抗 冬 荡 邓 挡 妄 烫 乓 裆 宕
血	学 解 续 询 雪 阅 鞋 讯 巡 泄 叙 岳 蝎 歇 卸
武	五 无 物 午 舞 误 吴 悟 伍 雾 呜 坞 芜 梧 捂
而	二 儿 哦 尔 恶 恩 耳 饿 饵 噩 厄 遏 贰 迩 胺
练	联 连 简 恋 脸 链 炼 怜 莲 廉 羡 帘 敛 斓 镰
纪	己 机 几 系 计 及 技 集 即 继 鸡 剂 肌 寂 挤
善	神 山 删 闪 厦 扇 陕 擅 衫 珊 杉 筛 蒜 汕 姗
钟	中 种 重 政 终 众 掌 综 障 崇 忠 虫 虹 仲 肿
嘛	吗 妈 马 码 亚 怕 米 麻 猫 骂 玛 涯 祂 啪 鸦
夫	福 付 负 富 妇 副 符 幅 肤 傅 伏 覆 赋 赴 辐
举	车 具 据 剧 局 句 巨 聚 距 拒 拘 矩 菊 橘 狙
围	未 维 委 味 威 谓 尾 慰 喂 胃 薇 魏 畏 潍 猥
忙	帮 访 央 棒 洋 钢 坊 茫 汪 盲 躺 芒 沧 妄 烫
土	图 古 退 突 顾 途 吐 徒 兔 涂 吞 逾 瑜 凸 醋
印	因 音 银 引 阴 隐 饮 姻 乙 淫 瘾 吟 殷 尹 茵
协	些 解 谢 写 鞋 械 邪 谐 蟹 携 泄 蝎 歇 卸 胁
严	验 延 炎 燕 盐 沿 岩 掩 宴 咽 衍 彦 腌 堰 檐
继	己 机 几 系 计 及 技 集 即 纪 鸡 剂 肌 寂 挤
顺	深 善 舒 沈 瞬 署 梳 杉 抒 朔 蜀 烁 姗 讪 舜
左	作 做 或 座 坐 昨 著 佐 琢 撮 拙 驼 灬 浊 唑
妹	没 美 每 媒 梅 煤 呗 魅 眉 玫 霉 枚 贼 昧 媚
恋	联 连 简 练 脸 链 炼 怜 莲 廉 羡 帘 敛 斓 镰
退	推 汇 托 途 腿 抬 锐 讳 癸 蹄 涕 颓 蜕 盔 嚏
奖	将 讲 江 降 镜 净 渐 辆 谅 疆 姜 酱 囧 蒋 僵
餐	言 版 晚 眼 案 参 湾 凡 残 惨 堪 埋 岩 碗 苍
靠	考 早 造 淘 烤 骚 阔 躁 澡 砍 坎 岆 瑶 拷 曜
毛	马 猫 贸 貌 冒 矛 妖 炮 苗 帽 茅 冇 茂 髦 蒿
右	有 又 由 优 油 邮 尤 幼 忧 幽 悠 犹 诱 呦 佑
汉	韩 淡 含 散 寒 涵 喊 汗 憾 函 堪 弯 撼 氨 旱
融	从 容 空 龙 荣 宋 孔 恭 冻 桶 蓉 绒 溶 熔 佟
批	皮 屁 脾 疲 匹 披 啤 劈 癖 坯 霹 琵 毗 媲 丕
灵	零 领 另 令 龄 凌 玲 铃 陵 岭 菱 聆 伶 拎 羚
掉	校 岛 脚 刀 蹈 尿 吊 屌 雕 喵 悄 钓 撩 飙 奠
牛	究 您 留 修 努 逆 怒 柳 纽 扭 妞 绣 捏 瘤 玖
突	图 古 土 退 顾 途 吐 徒 兔 涂 吞 逾 瑜 凸 醋
析	西 喜 习 吸 媳 晰 稀 溪 夕 兮 茜 玺 犀 烯 嬉
康	房 访 央 棒 狂 洋 钢 抗 矿 仰 旸 勘 沧 扛 壤
倒	到 道 导 答 药 岛 刀 盗 蹈 谣 骚 雕 稻 捣 叨
浪	龙 洋 钢 朗 昂 隆 粮 狼 芳 郎 痒 沧 廊 嗓 琅
贴	且 姐 铁 帖 嚏 忒 惬 婕 涅 啼 忑 亵 缇 丿 镍
紧	进 金 今 近 银 尽 仅 津 禁 劲 斤 锦 谨 晋 巾
篇	变 先 见 片 便 健 签 骗 偏 潜 兼 迁 践 淀 箭
典	点 电 店 段 连 蛋 垫 歉 莲 廉 辨 舰 颠 淀 殿
婆	破 默 魔 霸 坡 陌 脉 颇 泼 蜗 趴 菩 珀 陂 坯
翻	男 万 反 饭 范 烦 犯 凡 繁 胆 返 泛 汗 番 帆
嗡	梦 增 曾 登 闻 哼 庚 蚊 枫 翁 藤 懵 膨 僧 绷
趣	去 区 取 曲 趋 驱 屈 渠 娶 凸 醋 躯 佢 祛 蛆
皮	批 屁 脾 疲 匹 披 啤 劈 癖 坯 霹 琵 毗 媲 丕
当	帮 党 档 丁 扬 抗 冬 荡 挡 妄 烫 琅 乓 裆 宕
狗	够 购 故 构 古 骨 沟 勾 喽 酉 喉 钩 苟 疣 逅
卫	未 维 委 味 威 谓 尾 慰 喂 胃 薇 魏 畏 惟 潍
状	专 装 张 双 涨 皇 庄 妆 撞 壮 荒 凰 谎 慌 胀
悲	费 北 备 背 卫 贝 违 辈 杯 倍 呗 碑 卑 薇 佰
粉	分 认 门 份 飞 凡 奋 纷 喷 笨 纹 氛 愤 芬 逢
漫	男 满 范 慢 兰 贸 蛮 曼 番 埋 迈 婉 谭 衍 茂
县	现 先 限 险 鲜 献 闲 仙 陷 嫌 贤 宪 咸 掀 衔
聊	消 销 票 料 角 疗 辽 雕 肖 萧 撩 霄 礁 硝 窍
波	保 博 播 暴 伯 拨 玻 勃 搏 泊 驳 蔽 脖 渤 舶
监	间 件 简 检 坚 健 剑 兼 践 尖 舰 奸 贱 煎 碱
竟	经 精 京 境 景 竞 镜 净 敬 睛 径 晶 颈 殑 荆
罗	路 落 洛 逻 裸 啰 萝 螺 囖 璐 卤 噜 烙 骆 锣
询	训 雪 寻 讯 迅 循 巡 逊 旬 勋 熏 驯 薰 陨 浚
登	当 等 灯 仍 碰 邓 崩 彭 橙 澄 蹭 盯 耿 懵 凳
顾	股 故 古 估 固 骨 孤 姑 谷 雇 辜 菇 咕 沽 箍
港	房 刚 央 棒 钢 岗 杭 仰 逛 纲 杠 旸 纺 庞 缸
坐	作 做 或 座 左 昨 佐 琢 陀 撮 拙 驼 浊 唑 焯
怀	话 回 快 海 惠 坏 挥 辉 缓 徽 毁 乖 衰 淮 哗
折	这 着 者 至 喆 哲 浙 竹 蛇 枝 振 赫 遮 辙 褶
秀	续 戏 修 休 羞 袖 绣 斜 瘤 玖 狭 畜 絮 锈 朽
厂	场 常 唱 章 偿 昌 尝 畅 撑 肠 倡 敞 铲 殇 漳
顶	定 影 并 青 订 净 丁 凭 姓 鼎 钉 盯 荆 萍 冥
韩	南 航 汉 含 寒 涵 喊 汗 憾 函 弯 撼 旱 晗 焊
停	听 清 景 挺 庭 厅 订 兵 迎 堂 径 颖 婷 亭 廷
弟	地 第 低 底 递 帝 滴 迪 抵 敌 蒂 堤 笛 旳 缔
跑	靠 毛 婆 劳 抱 派 草 爆 判 泡 炮 抛 豹 枣 嚎
敢	感 干 赶 探 甘 燃 杆 岩 肝 尴 衍 旱 赣 丐 竿
庭	听 清 景 挺 停 厅 订 兵 迎 堂 径 颖 婷 亭 廷
喝	和 合 呢 设 何 则 呵 河 核 盒 荷 吓 赫 贺 禾
良	两 量 联 亮 抢 辆 梁 凉 粮 谅 酱 蒋 腔 靓 廊
丝	四 司 思 死 斯 食 素 似 私 撕 寺 肆 饲 嘶 厮
私	四 司 思 死 斯 食 素 似 丝 撕 寺 肆 饲 嘶 厮
疑	意 已 义 医 移 忆 仪 伊 谊 疫 毅 椅 溢 怡 颐
赞	站 眼 早 案 造 参 战 弹 凡 颜 咱 暂 宰 哉 攒
闻	文 问 微 温 粉 稳 纷 纹 吻 畏 挽 雯 蚊 潍 汶
静	经 精 京 境 景 竟 竞 镜 净 敬 睛 径 晶 颈 殑
铁	且 姐 贴 帖 嚏 忒 惬 婕 涅 啼 忑 亵 缇 丿 镍
族	组 续 局 足 租 筑 祖 紫 铺 阻 卜 炉 砸 尉 牡
绩	己 机 几 系 计 及 技 集 即 纪 继 鸡 肌 寂 挤
端	观 店 款 段 团 断 短 泉 诞 援 旋 贯 劝 垫 拳
执	之 知 直 制 职 置 志 智 止 织 纸 址 枝 旨 秩
邮	有 又 由 优 油 右 尤 幼 忧 幽 悠 犹 诱 呦 佑
审	身 设 神 深 申 甚 珍 剩 沈 伸 慎 肾 渗 绅 婶
止	之 知 直 制 职 置 志 智 织 纸 址 枝 芝 旨 秩
熟	数 书 术 述 输 叔 殊 暑 鼠 署 疏 蔬 梳 淑 抒
织	之 知 直 制 职 置 志 智 止 纸 址 枝 芝 旨 秩
脸	联 连 简 练 恋 链 炼 怜 莲 廉 谅 辽 帘 敛 斓
街	节 界 姐 借 阶 届 洁 截 揭 捷 戒 劫 羯 芥 诫
缺	确 取 却 雪 驱 悦 屈 娶 掘 玥 薛 诀 崛 茄 靴
劳	老 报 络 倒 跑 闹 矛 篮 咬 牢 捞 姥 佬 拦 唠
舞	五 无 物 午 武 误 吴 悟 伍 雾 呜 巫 芜 梧 捂
洗	西 喜 习 吸 媳 晰 稀 溪 夕 兮 茜 玺 犀 烯 嬉
诗	事 什 实 市 师 试 世 视 式 使 失 识 示 士 适
冲	重 城 充 乘 昌 尝 崇 虫 畅 宠 呈 洪 轰 秤 倡
麻	吗 妈 马 满 码 嘛 秘 骂 摩 牙 贸 玛 寞 抹 牧
忘	网 让 望 玩 帮 晚 王 往 亡 旁 汤 仿 旺 汪 妄
鱼	于 预 遇 域 余 雨 宇 愉 郁 愚 寓 裕 逾 瑜 舆
木	目 股 步 母 幕 徐 祖 慕 姆 牧 墓 娶 御 募 谜
痛	同 通 总 统 童 恭 铜 葱 筒 桶 桐 艇 彤 瞳 捅
苏	诉 速 素 丝 舞 宿 俗 塑 傅 肃 凸 醋 舆 巫 辜
烦	男 反 饭 范 翻 犯 凡 繁 胆 甘 返 泛 汗 番 帆
汽	起 其 七 弃 妻 旗 骑 棋 契 岂 祈 琦 凄 祁 脐
甚	身 设 神 深 申 审 珍 剩 沈 伸 慎 肾 渗 绅 婶
刘	六 流 留 绿 柳 炉 劣 浏 溜 赁 瘤 榴 硫 璐 漓
革	个 特 格 科 歌 各 哥 隔 割 戈 葛 鸽 阁 瑟 搁
喆	这 着 者 至 折 哲 浙 竹 蛇 枝 振 赫 遮 渣 辙
迷	积 米 礼 密 秘 蜜 弥 咪 谜 幂 泌 靡 沐 觅 琦
菜	才 带 吃 白 此 持 财 彩 材 采 哎 裁 猜 欸 挨
操	超 早 造 参 草 遭 稿 吵 扰 耗 腰 矛 曹 萄 钥
坏	话 回 快 海 惠 怀 帅 挥 辉 缓 徽 毁 乖 淮 哗
借	节 界 姐 街 阶 届 洁 截 揭 捷 戒 劫 羯 芥 诫
湖	户 互 乎 呼 胡 虎 忽 糊 狐 沪 壶 蝴 葫 弧 唬
伴	办 反 玩 帮 班 版 半 般 板 探 坛 搬 颁 斑 扮
冷	等 登 碰 萌 衡 凤 缝 耕 讽 梗 懵 膨 愣 棱 胧
略	乐 律 旅 列 虑 烈 裂 肋 侣 猎 虐 履 吕 滤 驴
威	未 维 委 味 谓 慰 喂 胃 薇 魏 畏 惟 潍 猥 萎
洲	主 手 候 周 州 守 宙 舟 骤 轴 丶 咒 粥 皱 蛛
冰	并 清 帮 星 精 病 灵 兵 屏 赢 刑 饼 丙 秉 菱
第	地 低 底 弟 递 帝 滴 迪 抵 敌 蒂 堤 笛 旳 缔
估	股 故 古 顾 鼓 固 骨 孤 姑 谷 雇 辜 咕 沽 箍
宁	名 境 兵 迎 镜 净 盈 凝 颈 廷 霆 卿 菱 乒 氢
鲜	现 先 限 县 献 闲 仙 陷 嫌 贤 羡 宪 咸 掀 衔
季	己 机 集 击 激 辑 既 寂 忌 稽 饥 姬 嫉 脊 妓
斗	优 独 豆 偷 尤 悠 柔 逗 兜 抖 痘 剖 陡 窦 牟
楚	出 吃 处 初 除 础 触 储 厨 丶 橱 雏 锄 孰 矗
减	间 件 简 检 坚 健 剑 兼 践 尖 舰 奸 贱 煎 碱
纳	那 哪 哈 拿 码 亚 怕 罚 娜 涯 哒 呐 匿 噶 趴
虑	利 律 率 旅 垃 辣 侣 履 吕 芦 滤 驴 铝 屡 缕
惊	经 精 京 境 景 竟 竞 镜 净 敬 睛 径 晶 颈 殑
租	步 组 续 局 足 族 筑 祖 紫 阻 卜 炉 砸 尉 牡
述	数 书 术 熟 输 叔 殊 暑 鼠 署 疏 蔬 梳 淑 抒
讨	套 岛 淘 逃 桃 陶 涛 萄 佬 掏 韬 褒 滔 绸 挞
嘅	开 待 卖 态 凯 癌 堪 迈 烤 蔡 宰 哉 慨 霾 歹
掌	长 重 张 章 厂 账 涨 障 帐 丈 胀 仗 彰 绽 栈
荐	间 件 简 检 坚 健 剑 兼 践 尖 舰 奸 贱 煎 碱
宜	意 已 义 医 移 忆 仪 伊 谊 疫 毅 椅 溢 怡 颐
键	间 件 简 检 坚 健 剑 兼 践 尖 舰 奸 贱 煎 碱
纯	存 春 村 沉 川 混 储 寸 趁 蠢 唇 锤 喘 醇 铲
域	于 预 遇 余 雨 宇 愉 郁 愚 寓 豫 裕 逾 瑜 舆
奶	能 男 白 难 台 拜 盖 耐 奈 挨 哀 恼 乃 亥 暧
账	长 重 张 章 厂 掌 涨 障 帐 丈 胀 仗 彰 绽 栈
鼓	股 故 古 顾 估 固 骨 孤 姑 谷 雇 辜 菇 咕 沽
奥	博 早 案 造 澳 傲 熬 凹 瑶 敖 嗷 袄 艹 蘑 懊
临	留 李 林 邻 琳 淋 赁 菱 榴 吟 彬 沦 硫 麟 霖
索	所 错 素 宿 锁 缩 裹 琐 梭 嗦 骆 蓑 祟 唆 跎
余	于 预 遇 域 雨 宇 愉 郁 愚 寓 裕 逾 瑜 舆 榆
欧	族 邮 舞 鱼 木 苏 湖 偶 喽 敷 瑜 喉 芦 钩 殴
雨	于 预 遇 域 余 宇 愉 郁 愚 寓 裕 逾 瑜 舆 榆
误	五 无 务 物 武 吴 悟 雾 呜 巫 侮 芜 捂 毋 钨
小	先 笑 消 销 效 跳 晓 孝 肖 萧 削 宵 潇 嚣 霄
降	量 将 讲 江 警 奖 竟 良 静 剑 兼 鉴 疆 姜 酱
础	出 吃 处 初 除 楚 触 储 撤 殊 厨 橱 雏 锄 诧
括	货 火 获 库 扩 昆 啰 躲 挫 祸 阔 馈 萝 愧 廓
累	位 类 备 雷 泪 勒 赖 玫 啡 蕾 磊 沸 莓 潍 垒
救	就 九 结 究 济 即 酒 久 旧 纠 忌 舅 揪 玖 韭
汇	回 惠 挥 慧 灰 悔 辉 徽 毁 绘 恢 贿 讳 卉 晖
抱	保 报 号 包 宝 爆 暴 薄 逃 饱 堡 遥 剥 胞 曝
兰	担 蓝 厌 览 烂 懒 篮 栏 滥 谭 衍 旱 晗 攒 拦
童	同 通 总 统 痛 隆 浓 铜 庸 筒 桶 桐 彤 瞳 捅
杀	社 术 示 啥 沙 傻 狮 烧 叔 删 厦 纱 莎 舌 砂
输	数 术 熟 述 树 叔 殊 暑 鼠 署 疏 蔬 梳 淑 抒
醒	行 性 星 形 型 兴 幸 姓 刑 馨 鑫 鹰 萍 秉 杏
贝	费 北 备 背 卫 悲 雷 违 辈 杯 倍 呗 碑 卑 佰
察	差 楚 触 茶 插 储 扎 莎 叉 耻 侈 蝉 岔 榨 眨
厅	听 清 景 挺 停 庭 订 兵 迎 堂 径 颖 婷 亭 廷
休	续 戏 修 秀 羞 袖 绣 斜 瘤 玖 狭 畜 絮 锈 朽
拥	用 营 永 勇 赢 洞 铜 庸 泳 涌 佣 咏 雍 棕 甬
恶	哦 俄 饿 鹅 噩 厄 鄂 遏 娥 讹 扼 胺 峨 鳄 愕
托	活 左 突 罗 脱 拖 逃 拓 陶 妥 螺 吞 魄 陀 搓
吸	西 喜 习 媳 晰 稀 溪 夕 兮 茜 犀 烯 熄 嬉 羲
侧	色 客 热 策 测 册 厕 促 涩 椰 醋 赐 磕 冶 棵
令	零 领 另 灵 龄 凌 玲 铃 陵 岭 荆 菱 聆 伶 拎
庆	情 请 并 清 亲 评 青 轻 顶 庭 倾 陵 晴 卿 擎
途	图 足 句 土 突 宿 屋 欲 促 吐 徒 兔 涂 叙 愈
松	红 共 送 供 融 宋 踪 讼 轰 诵 颂 嵩 怂 耸 悚
肉	友 候 入 楼 油 购 欧 幽 悠 柔 猴 兜 佑 喉 揉
尼	你 李 急 依 拟 泥 逆 姨 妮 腻 伱 倪 霓 匿 昵
今	进 金 音 近 尽 仅 紧 阴 津 禁 劲 斤 锦 肩 谨
恩	怎 安 哦 额 肯 稳 狠 饿 鹅 氨 啃 鄂 汾 汶 讹
佳	家 加 价 假 架 驾 甲 嘉 嫁 寂 夹 贾 迦 钾 戛
馆	关 管 观 官 软 惯 冠 钻 贯 灌 莞 罐 棺 纶 眷
贷	代 带 导 改 待 嘚 哎 搭 戴 呆 袋 哀 栽 歹 黛
绍	少 超 朝 烧 硕 炒 稍 闪 召 吵 兆 擅 珊 邵 汕
释	什 实 师 试 世 视 式 使 失 识 示 士 适 饰 驶
鸡	己 机 集 击 激 辑 既 寂 忌 稽 饥 姬 嫉 脊 妓
序	需 许 续 须 虚 绪 徐 蓄 叙 旭 畜 絮 恤 婿 墟
派	白 牌 排 拍 嘅 奶 胎 胖 迫 拌 钙 趴 耙 佰 沛
祝	助 筑 猪 逐 珠 诸 竹 驻 柱 煮 丶 烛 株 嘱 铸
宣	选 旋 悬 暅 炫 玄 轩 萱 喧 渲 绚 璇 嬛 眩 漩
币	比 笔 逼 避 鼻 彼 壁 碧 鄙 弊 辟 臂 蔽 屄 毙
本	文 认 班 忍 奔 呗 颁 笨 芬 盆 苯 甭 汾 惫 摁
乡	想 相 像 向 象 项 响 香 享 箱 详 闲 翔 祥 湘
杂	再 哪 哈 达 马 搭 咯 娃 涯 诈 躁 澡 砸 阀 喇
丰	更 风 封 峰 蒙 疯 凤 锋 奉 缝 蜂 冯 逢 讽 枫
媒	没 美 每 备 妹 梅 煤 呗 魅 眉 玫 霉 枚 贼 妃
疗	票 叫 效 料 角 聊 辽 雕 肖 撩 霄 礁 窍 寥 廖
榜	帮 访 央 棒 洋 邦 绑 仰 苍 丧 纲 膀 磅 缸 枉
草	早 造 参 操 遭 稿 吵 扰 耗 腰 矛 曹 萄 钥 袍
归	该 规 贵 鬼 柜 轨 毁 醉 跪 瑰 桂 闺 龟 硅 卦
爷	也 业 越 夜 野 页 叶 液 耶 椰 冶 噎 矣 烨 琊
困	讯 轮 裤 昆 阔 敦 馈 坤 吞 蕴 垮 峻 芸 捆 窟
弄	农 宁 童 拥 松 隆 浓 贡 佣 匆 栋 丛 垄 彤 耸
爆	保 报 号 包 宝 抱 暴 薄 拔 饱 堡 遥 剥 胞 曝
诚	成 程 城 充 声 承 盛 乘 撑 呈 肠 秤 惩 甸 敞
旧	就 九 价 究 酒 久 街 救 纠 戒 纽 舅 揪 玖 韭
弃	起 其 七 汽 妻 旗 骑 棋 契 岂 祈 琦 凄 砌 脐
昨	作 做 或 座 左 坐 著 佐 琢 撮 驼 灬 浊 唑 焯
拜	百 办 孩 北 白 排 板 拍 败 泰 摆 柏 奈 卑 碍
怪	关 观 规 官 贵 块 概 怀 坏 馆 归 惯 贯 跪 瑰
判	盘 谈 范 慢 频 胖 盼 潘 叛 攀 贩 炭 滥 婉 谭
从	童 藏 综 聪 贡 洪 恭 葱 匆 丛 哄 沧 憧 珑 聋
逼	比 笔 币 避 鼻 彼 壁 碧 鄙 弊 辟 臂 蔽 屄 毙
稳	文 问 微 温 卫 粉 闻 纷 纹 吻 畏 挽 丸 雯 蚊
乱	券 幻 缘 圆 卷 患 缓 炼 览 烂 怨 泉 捐 卵 栾
忆	意 已 义 医 移 仪 伊 谊 疫 毅 椅 溢 怡 颐 咦
朝	号 超 差 潮 烧 赵 炒 吵 耗 抄 缠 嘲 罩 巢 钞
暗	安 完 班 干 演 案 按 兰 蛮 甘 岸 俺 氨 鞍 揽
雪	学 解 续 血 询 阅 鞋 讯 巡 泄 叙 岳 蝎 歇 卸
蛋	但 单 担 严 暗 淡 丹 旦 胆 诞 耽 氮 宛 郸 惮
圈	短 检 健 软 监 端 卷 捐 劵 倦 娟 眷 柬 嬛 辕
藏	让 场 从 羊 仓 荡 邦 郎 苍 灿 趟 芒 沧 蚕 舱
订	定 影 青 顶 冰 净 丁 凭 姓 鼎 钉 莹 盯 荆 萍
纸	知 直 至 指 支 置 止 织 枝 脂 汁 肢 秩 挚 蜘
骗	变 先 见 片 便 健 签 篇 偏 潜 兼 迁 践 淀 箭
均	运 近 军 仅 寻 巨 君 俊 晕 循 菌 骏 狙 峻 钧
附	福 付 负 富 府 夫 副 符 幅 肤 浮 傅 伏 覆 赴
兵	并 清 帮 星 精 病 灵 冰 屏 赢 刑 饼 丙 秉 菱
岛	到 道 导 答 药 倒 刀 盗 蹈 谣 骚 雕 躁 岆 瑶
迎	应 影 英 营 硬 映 赢 盈 颖 婴 鹰 樱 莹 荧 萤
吉	己 机 集 击 激 辑 既 寂 忌 稽 饥 姬 嫉 脊 妓
厕	色 客 热 策 测 册 侧 促 涩 椰 醋 赐 磕 冶 棵
堂	让 挺 档 疼 唐 糖 汤 脏 躺 塘 趟 烫 扛 盎 棠
刷	化 啥 述 杀 输 舒 滑 暑 耍 莎 衰 疏 抒 赎 哗
败	百 办 孩 北 带 白 排 板 拍 拜 泰 摆 柏 卑 碍
辑	己 机 集 击 激 吉 既 寂 忌 稽 饥 姬 嫉 脊 妓
阶	结 姐 介 街 借 洁 截 揭 捷 戒 皆 劫 羯 桔 诫
毒	都 度 读 独 督 堆 盾 裤 杜 赌 肚 渡 堵 妒 嘟
涨	长 重 张 章 争 厂 掌 账 障 帐 丈 胀 仗 葬 彰
谓	位 微 味 卫 威 慰 伪 胃 薇 韦 畏 惟 猥 萎 玮
守	手 收 受 首 售 厚 授 寿 兽 瘦 轴 蔬 淑 粥 抒
征	正 证 政 整 争 针 郑 症 挣 肿 衷 蒸 拯 睁 筝
握	我 误 卧 窝 污 挖 哇 膜 沃 涡 喔 颇 勃 倭 蜗
既	己 机 集 击 激 吉 辑 寂 忌 稽 饥 姬 嫉 脊 妓
尚	上 长 商 张 山 伤 双 章 升 赏 障 昇 胀 甸 嗓
夏	下 解 息 欣 侠 瞎 霞 蝎 虾 辖 峡 潇 狭 锌 曦
虚	需 许 续 须 序 雪 绪 徐 蓄 叙 旭 畜 絮 恤 婿
猫	妈 马 毛 闹 贸 貌 冒 矛 妖 炮 迈 烤 苗 糟 帽
摄	师 设 社 属 核 舍 射 涉 鼠 蛇 奢 舌 誓 薯 慑
惯	关 管 观 官 软 馆 冠 钻 贯 灌 莞 罐 棺 纶 眷
暴	保 报 号 包 宝 抱 爆 薄 逃 拔 饱 堡 剥 胞 曝
档	当 单 东 帮 党 旦 仓 荡 挡 郎 旺 躺 旸 耽 廊
赶	感 万 跟 干 敢 残 甘 憾 贪 杆 肝 尴 扳 嘎 赣
若	弱 锁 朵 乳 逻 拓 萝 琢 魄 梭 挪 饶 唾 锣 糯
脚	交 较 叫 角 缴 焦 胶 娇 椒 矫 搅 蕉 浇 饺 轿
封	更 风 丰 峰 疯 凤 锋 奉 缝 蜂 冯 逢 讽 枫 绷
露	又 路 头 楼 否 录 豆 陆 搜 漏 炉 喽 苟 陋 庐
伙	活 或 货 火 获 魂 扩 惑 霍 祸 裹 豁 昊 剁 壕
寻	论 训 询 讯 迅 循 昆 巡 逊 旬 勋 熏 驯 薰 浚
亿	意 已 义 医 移 仪 伊 谊 疫 毅 椅 溢 怡 颐 咦
豆	优 独 斗 偷 尤 悠 柔 逗 兜 抖 痘 剖 陡 窦 牟
默	模 魔 末 摩 莫 磨 摸 膜 墨 陌 脉 寞 抹 漠 沫
陆	录 绿 鲁 鹿 炉 卢 碌 撸 芦 璐 卤 禄 噜 泸 虏
娘	相 两 香 享 奖 良 梁 凉 粮 翔 祥 谅 囊 浆 靓
架	家 加 价 假 佳 驾 甲 嘉 嫁 锦 夹 贾 迦 钾 戛
唯	位 微 味 威 谓 慰 伪 胃 薇 韦 畏 惟 猥 萎 玮
沉	称 陈 甚 晨 扯 沈 尘 诊 辰 臣 趁 衬 秤 铲 绅
巨	车 具 据 剧 局 居 聚 距 拒 拘 矩 菊 橘 狙 鞠
硬	应 影 英 营 迎 映 赢 盈 颖 婴 鹰 樱 莹 荧 萤
箱	想 相 像 向 象 项 响 香 享 良 乡 详 翔 祥 湘
陪	位 被 配 培 威 赔 倍 废 佩 玫 韦 匹 匪 惟 沛
竞	经 精 京 境 景 静 镜 净 敬 睛 径 晶 颈 殑 荆
淡	但 单 担 严 翻 暗 蛋 丹 旦 胆 诞 耽 氮 郸 惮
含	航 汉 韩 寒 涵 喊 汗 憾 函 俺 撼 旱 晗 焊 翰
野	也 业 夜 爷 页 叶 液 泽 耶 曰 椰 冶 噎 矣 讹
嚒	么 门 呢 何 歌 河 刻 夜 魔 蜜 液 摸 瑟 沫 禾
刀	到 道 导 脑 药 倒 岛 盗 蹈 谣 骚 雕 稻 捣 叨
佛	婆 波 魔 膜 哟 拨 沃 脉 凹 漠 泊 驳 阀 脖 咐
镇	真 针 珍 圳 震 阵 诊 振 贞 甄 枕 帧 疹 臻 朕
译	意 已 义 医 移 仪 伊 谊 疫 毅 椅 溢 怡 颐 咦
散	三 山 班 干 演 淡 含 犯 懒 潘 宴 叛 咽 伞 绊
犯	男 万 反 饭 范 翻 烦 凡 繁 胆 返 泛 汗 番 帆
阅	月 越 却 余 雨 叶 悦 跃 岳 豫 喻 韵 浴 掘 玥
川	换 穿 船 患 窗 缓 串 缠 阐 馋 撰 喘 醇 桓 篡
鞋	些 解 谢 写 协 械 邪 谐 蟹 携 泄 蝎 歇 卸 胁
遍	变 片 边 编 减 辩 辨 贬 纤 弦 勉 宪 煎 捡 咸
弹	言 眼 案 谈 探 湾 坛 坦 摊 贪 叹 堪 碳 滩 炭
罪	最 制 随 坐 族 址 尊 嘴 柜 植 亏 醉 翠 咀 淄
雷	类 备 历 累 泪 勒 赖 玫 黎 啡 蕾 磊 莓 潍 垒
沙	社 术 示 啥 杀 傻 狮 烧 叔 删 厦 纱 莎 舌 砂
雅	亚 呀 压 牙 押 涯 鸭 谣 寓 丫 吖 芽 讶 哑 鸦
综	同 重 总 空 控 宗 宏 纵 泳 踪 弘 垄 巩 瞳 棕
扣	友 候 又 口 构 某 苦 幼 奏 呦 吼 枯 抠 逅 嗽
库	股 步 组 苦 符 哭 酷 裤 惧 赋 浴 枯 缚 埔 溯
启	起 其 七 奇 汽 弃 妻 旗 骑 棋 契 岂 祈 琦 凄
淘	套 药 络 搞 讨 逃 桃 陶 叹 胞 涛 萄 掏 陀 韬
偶	族 木 苏 湖 欧 喽 酉 逾 瑜 喉 芦 钩 殴 呕 鸥
页	也 业 越 夜 爷 野 叶 液 盒 耶 曰 椰 冶 噎 矣
盖	该 海 改 载 财 排 害 概 菜 泰 鬼 奈 肝 矮 抬
暖	宽 券 幻 缘 圆 卷 冠 酸 患 缓 怨 泉 悬 锻 煅
触	出 吃 处 初 除 楚 础 储 殊 厨 唇 橱 雏 锄 诧
杨	样 房 养 阳 央 洋 扬 羊 仰 脏 氧 旸 痒 烊 秧
胜	生 整 声 省 升 圣 盛 症 剩 衡 昇 牲 肾 绳 甸
赚	专 转 传 战 环 占 抓 幻 船 妆 患 撞 砖 粘 撰
递	地 第 低 底 弟 帝 滴 迪 抵 敌 蒂 堤 笛 旳 缔
聚	车 局 句 举 距 俱 惧 矩 菊 焗 橘 狙 鞠 驹 沮
床	装 创 窗 凰 谎 慌 倡 霜 闯 煌 晃 桩 敞 恍 疮
探	言 眼 谈 弹 坛 坦 摊 贪 叹 堪 埋 碳 滩 炭 谭
跳	表 教 调 条 挑 描 胶 苗 辽 骄 礁 韬 硝 窍 啸
讯	论 训 询 寻 迅 循 昆 巡 逊 旬 勋 熏 驯 薰 陨
魔	默 末 摩 莫 磨 摸 膜 墨 陌 脉 寞 抹 漠 沫 麽
轮	论 损 伦 混 逻 允 逊 裙 旬 拦 沦 仑 芸 禄 捆
耳	二 而 儿 哦 尔 额 恶 恩 饿 诶 饵 厄 遏 贰 讹
遗	艺 依 姨 翼 乙 抑 逸 疫 毅 溢 奕 弈 祎 蚁 沂
搜	由 楼 优 首 投 鼠 猴 兜 署 肃 抖 嗽 艘 鱿 黍
新	心 信 线 音 欣 辛 薪 勤 芯 鑫 峡 寝 斌 锌 昕
妇	福 付 负 富 府 夫 副 符 幅 肤 傅 伏 覆 赋 赴
伟	位 微 味 威 谓 慰 伪 胃 薇 韦 畏 惟 猥 萎 玮
哎	爱 继 艾 唉 碍 埃 欸 挨 哀 晰 癌 矮 暧 吏 隘
湾	完 万 玩 晚 挖 弯 碗 挽 塆 丸 婉 顽 腕 榄 宛
挂	关 华 股 归 怪 锅 谷 滚 瓜 瑰 龟 拐 硅 罐 刮
弱	若 锁 朵 乳 逻 拓 萝 琢 魄 梭 挪 饶 唾 锣 糯
危	位 微 味 威 谓 慰 伪 胃 薇 韦 畏 惟 猥 萎 玮
田	天 联 线 填 甜 添 尖 陷 廉 宪 煎 捡 咸 舔 恬
透	头 图 由 投 偷 尤 厚 沟 徒 犹 兜 喉 钩 凸 秃
访	方 放 房 防 亡 糖 繁 旁 凤 汤 仿 芳 坊 妨 纺
赏	上 长 商 张 山 伤 章 升 尚 障 昇 胀 甸 嗓 殇
抽	出 后 手 处 州 初 售 厚 丑 筹 厨 臭 酬 愁 猴
央	样 房 养 阳 杨 洋 扬 羊 仰 脏 氧 旸 痒 烊 秧
址	直 至 指 支 置 致 止 织 纸 枝 脂 吱 肢 秩 挚
忍	人 分 本 认 门 任 根 恩 润 仁 吻 苯 扔 韧 壬
棒	帮 榜 访 央 洋 邦 绑 仰 苍 丧 纲 膀 磅 缸 枉
占	展 站 战 韩 宅 粘 颤 詹 沾 斩 湛 绽 栈 瞻 讪
副	福 付 负 富 夫 妇 符 幅 肤 傅 伏 覆 赋 赴 辐
脱	活 左 罗 托 拖 逃 拓 妥 螺 吞 魄 挪 陀 搓 臀
尊	足 军 座 询 坐 轮 俊 醉 阻 循 遵 敦 琢 勋 峻
违	位 微 味 威 谓 慰 伪 胃 薇 韦 畏 惟 猥 萎 玮
届	接 结 姐 介 街 借 阶 洁 截 揭 皆 劫 羯 桔 诫
惜	西 喜 习 吸 媳 晰 稀 溪 夕 兮 茜 犀 烯 熄 嬉
蓝	担 络 兰 览 烂 懒 篮 栏 滥 谭 衍 攒 拦 澜 揽
束	数 术 熟 述 输 叔 殊 暑 鼠 署 疏 蔬 梳 淑 抒
末	模 默 魔 摩 莫 磨 摸 墨 陌 脉 寞 抹 漠 沫 麽
针	真 镇 珍 圳 震 阵 诊 振 侦 贞 甄 枕 帧 疹 臻
狂	广 况 黄 宽 抗 矿 荒 框 凰 谎 煌 晃 旷 惶 匡
绿	录 陆 鲁 鹿 炉 卢 碌 撸 芦 璐 庐 禄 噜 泸 虏
荣	容 共 融 童 拥 松 浓 笼 佣 匆 蓉 绒 溶 垄 壤
杰	接 结 节 姐 介 街 借 阶 洁 截 揭 皆 劫 羯 桔
龄	零 领 另 灵 令 凌 玲 铃 陵 岭 菱 聆 伶 拎 羚
符	福 付 负 富 府 夫 妇 副 幅 肤 傅 伏 覆 赋 赴
驾	家 加 价 假 佳 架 甲 嘉 嫁 锦 夹 贾 迦 钾 戛
搭	大 打 达 答 迪 牙 娜 塔 旦 敌 戴 玛 娃 胆 踏
舍	师 设 社 属 核 摄 射 涉 鼠 蛇 奢 舌 誓 薯 慑
详	想 相 像 向 象 项 响 香 享 乡 箱 陷 翔 祥 湘
圣	生 整 声 省 升 征 胜 盛 症 剩 衡 昇 牲 肾 绳
偷	头 图 由 投 透 尤 厚 沟 徒 犹 兜 喉 钩 凸 秃
茶	差 楚 察 沙 触 插 储 扎 莎 叉 耻 岔 榨 眨 茬
损	军 询 索 孙 碎 俊 晕 沦 蹲 仑 笋 酥 炖 郡 遁
妻	起 其 七 奇 汽 弃 旗 骑 棋 契 岂 祈 琦 凄 脐
玉	于 预 遇 域 余 雨 宇 愉 郁 愚 寓 逾 瑜 舆 榆
挑	表 教 调 条 跳 描 胶 苗 辽 骄 礁 韬 硝 窍 啸
凡	男 万 反 饭 范 翻 烦 犯 繁 胆 返 泛 汗 番 帆
缴	教 交 校 较 叫 角 脚 焦 胶 娇 椒 矫 搅 蕉 浇
灯	当 等 登 仍 碰 邓 彭 耕 橙 澄 蹭 盯 耿 懵 凳
勇	用 永 拥 赢 洞 铜 庸 泳 涌 佣 咏 雍 棕 熔 甬
宽	快 院 算 款 狂 幻 缘 援 劝 框 拳 昆 倦 猿 垣
聘	品 名 平 评 兴 令 庆 镜 凭 瓶 苹 赢 刑 颈 廷
辈	北 类 备 配 黑 背 妹 悲 贝 谓 杯 倍 呗 碑 卑
烈	留 列 裂 猎 劣 咧 膊 戾 偕 秸 丿 镍 遴 砾 乜
洋	样 放 房 养 阳 杨 央 扬 羊 仰 脏 氧 旸 痒 烊
钢	房 刚 阳 往 供 港 扬 抗 岗 绑 郎 苍 纲 躺 杠
树	数 术 熟 述 输 束 叔 殊 暑 鼠 署 疏 蔬 梳 淑
伦	论 轮 混 逻 允 逊 裙 旬 拦 沦 仑 芸 禄 捆 颅
峰	更 风 丰 封 疯 凤 锋 奉 芬 缝 蜂 冯 逢 讽 枫
偏	变 先 见 片 便 健 签 篇 骗 潜 兼 迁 践 淀 箭
烟	验 严 颜 炎 艳 燕 盐 岩 掩 宴 咽 衍 腌 堰 焉
混	论 婚 护 获 虎 挥 润 魂 憾 晕 昆 沪 浑 昏 匀
豪	好 号 包 导 告 汉 毫 薄 澳 耗 浩 胞 嚎 昊 壕
券	全 权 幻 缘 圆 卷 酸 潜 迁 患 泉 劝 拳 犬 诠
固	股 故 古 顾 估 鼓 骨 孤 姑 谷 雇 辜 菇 咕 沽
尤	有 又 游 优 油 右 邮 幼 忧 幽 悠 犹 诱 呦 佑
抓	花 转 传 注 华 祝 逐 桌 砖 驻 丶 撰 烛 哗 坠
帝	地 第 低 底 弟 递 滴 迪 抵 敌 蒂 堤 笛 旳 缔
避	比 必 笔 币 逼 鼻 彼 壁 碧 鄙 弊 辟 臂 蔽 屄
攻	工 公 功 共 供 控 宗 宫 贡 恭 讼 咏 庚 巩 弓
漂	交 校 片 票 骗 脚 跳 炮 朴 飘 喵 浇 嫖 缪 狡
幻	欢 换 环 患 缓 涵 喊 汗 钻 唤 焕 桓 痪 寰 浣
跌	谐 裂 爹 蟹 携 皆 猎 泄 蒂 蝎 劣 歇 劫 卸 憋
咨	自 子 资 字 仔 紫 姿 滋 兹 孜 籽 淄 梓 疵 呲
舒	数 术 熟 述 输 束 树 叔 殊 暑 鼠 署 疏 蔬 淑
珍	真 镇 针 圳 震 阵 诊 振 侦 贞 甄 枕 帧 疹 臻
诺	或 座 获 托 缩 萝 挪 搓 惰 懦 唾 锣 糯 廓 铎
映	应 影 英 营 迎 硬 赢 盈 颖 婴 鹰 樱 莹 荧 蝇
欣	心 新 信 银 形 限 您 辛 拼 劲 薪 芯 鑫 昔 膝
励	理 里 力 利 立 历 礼 例 丽 莉 隶 哩 漓 犁 篱
颜	验 严 烟 炎 艳 燕 盐 岩 掩 宴 咽 衍 腌 堰 焉
咱	言 站 案 造 参 战 赞 凡 烟 颜 暂 宰 哉 攒 绽
泰	太 代 再 台 态 替 腿 胎 梯 涛 抬 汰 苔 嚏 钛
幕	目 母 录 木 屋 欲 促 慕 姆 肃 寞 堵 寓 牧 墓
呼	户 护 互 乎 湖 胡 虎 忽 糊 狐 沪 壶 蝴 葫 弧
甲	家 加 价 假 佳 架 驾 嘉 嫁 恰 锦 夹 贾 迦 钾
鬼	该 规 贵 归 柜 轨 醉 跪 瑰 桂 闺 龟 硅 卦 诡
嘴	最 制 随 坐 族 罪 址 尊 植 亏 醉 溃 翠 咀 淄
厚	后 候 收 又 口 否 扣 偶 搜 透 猴 抖 侯 吼 喉
滴	地 第 低 底 弟 递 帝 迪 抵 敌 蒂 堤 笛 旳 缔
她	他 图 妈 它 达 塔 踏 瓦 鸭 叭 爬 塌 祂 惕 咔
叶	也 业 何 歌 夜 爷 野 页 宇 液 耶 椰 冶 吁 噎
仍	更 嗡 登 腾 盟 崩 缝 蜂 扔 泵 绒 蹭 溶 梗 庚
晓	小 笑 消 销 效 孝 肖 萧 削 宵 潇 饺 嚣 霄 硝
哭	股 步 组 苦 库 符 酷 裤 惧 赋 枯 缚 埔 溯 侮
障	种 长 装 张 伤 章 钟 掌 账 涨 挣 帐 丈 胀 倡
缘	原 院 元 远 源 愿 圆 怨 援 袁 苑 冤 渊 媛 猿
秘	米 密 迷 吸 蜜 弥 咪 谜 幂 泌 靡 觅 眯 糜 芈
射	师 设 社 属 核 摄 舍 涉 鼠 蛇 奢 舌 誓 薯 慑
筑	主 注 住 助 猪 珠 朱 诸 柱 煮 丶 烛 株 嘱 铸
残	研 言 版 晚 眼 案 参 餐 湾 惨 堪 埋 岩 碗 苍
镜	经 精 京 境 警 竟 静 竞 净 敬 睛 径 晶 殑 荆
骂	吗 妈 它 达 马 满 码 嘛 麻 牙 贸 玛 寞 塌 抹
杯	北 备 配 黑 背 悲 贝 谓 辈 倍 呗 碑 卑 碧 臂
摩	模 默 魔 末 莫 磨 摸 膜 墨 陌 脉 寞 抹 漠 沫
净	经 精 京 境 警 竟 静 竞 镜 敬 睛 径 晶 殑 荆
迪	地 第 低 底 弟 递 帝 滴 抵 敌 蒂 堤 笛 旳 缔
授	手 数 收 书 受 术 首 售 守 抽 树 丑 筹 寿 兽
辛	心 新 信 银 形 限 您 欣 拼 劲 薪 芯 鑫 膝 杏
盛	成 程 城 充 声 承 诚 乘 昌 撑 呈 肠 秤 惩 敞
圳	真 镇 针 珍 震 阵 诊 振 侦 贞 甄 枕 帧 疹 臻
牙	妈 亚 呀 压 雅 押 涯 鸭 谣 丫 吖 芽 讶 哑 鸦
恐	东 从 空 控 融 康 勇 孔 庸 泳 诵 蓉 颂 绒 弘
灾	在 再 海 孩 载 牌 罪 胎 植 呆 碍 埃 欸 栽 宰
骨	股 故 古 顾 估 鼓 固 孤 姑 谷 雇 辜 菇 咕 沽
渐	间 件 简 监 减 荐 键 剑 兼 践 鉴 浅 艰 肩 奸
帅	说 水 传 税 睡 怀 坏 刷 晒 耍 衰 摔 甩 淮 筛
献	现 限 县 鲜 闲 仙 陷 嫌 羡 咁 宪 咸 掀 衔 腺
秋	求 球 救 仇 丘 寝 钮 邱 琦 凄 囚 臼 糗 遛 裘
胡	户 护 互 乎 湖 呼 虎 忽 糊 狐 沪 壶 蝴 葫 弧
沟	优 够 购 构 狗 厚 骨 勾 佑 喽 喉 钩 苟 眸 疣
刺	次 此 词 急 笔 击 材 辞 圾 磁 慈 瓷 赐 茨 伺
酷	股 步 组 苦 库 符 哭 裤 惧 赋 枯 缚 埔 溯 窟
您	民 念 宁 辛 妮 锦 秦 芯 筋 昵 楠 碾 沁 廿 殡
肥	费 非 份 飞 菲 废 氛 啡 肺 妃 匪 沸 绯 翡 斐
著	桌 卓 祸 捉 丶 烛 爪 拙 灼 赘 浊 绰 酌 镯 诏
圆	原 院 元 远 源 愿 园 缘 怨 援 袁 苑 冤 渊 媛
闲	现 限 县 鲜 献 仙 陷 嫌 羡 咁 宪 咸 掀 衔 腺
插	差 察 茶 池 拆 擦 痴 叉 岔 掺 铲 茬 乍 锄 诧
泪	位 类 备 累 雷 勒 赖 玫 啡 蕾 磊 沸 莓 潍 垒
丁	定 听 星 顶 订 灯 聘 铭 鼎 鹰 钉 盯 叮 坪 卿
兄	想 行 性 星 形 响 幸 姓 雄 熊 胸 祥 囧 凶 襄
抢	强 象 项 签 良 潜 迁 枪 墙 腔 靓 呛 钳 蔷 锵
勒	类 备 丽 累 雷 泪 赖 玫 黎 蕾 磊 沸 莓 潍 垒
洁	接 结 姐 介 街 借 阶 杰 截 揭 戒 劫 羯 桔 诫
闹	男 脑 豪 诺 糕 扫 妖 炮 桃 槽 耀 恼 捞 挠 灶
巧	表 桥 胶 乔 娇 吊 孝 萧 敲 喵 悄 瞧 雀 侨 翘
扬	样 放 房 养 阳 杨 央 洋 羊 仰 脏 氧 旸 痒 烊
莫	模 默 魔 末 摩 磨 摸 膜 墨 陌 脉 寞 抹 漠 沫
敬	经 精 京 境 警 竟 静 竞 镜 净 睛 径 晶 殑 荆
凭	品 名 平 评 轻 兴 令 庆 聘 瓶 苹 赢 刑 颈 廷
嘉	家 加 价 假 佳 架 驾 甲 嫁 夹 贾 瑕 迦 钾 戛
桥	表 巧 胶 乔 娇 吊 孝 萧 敲 悄 瞧 雀 矫 侨 翘
孤	股 故 顾 估 鼓 固 骨 姑 谷 雇 辜 菇 咕 沽 箍
奋	分 认 门 份 飞 粉 凡 纷 喷 笨 纹 氛 愤 芬 逢
震	真 镇 针 珍 圳 阵 诊 振 侦 贞 甄 枕 帧 疹 臻
奔	本 认 班 悲 呗 颁 笨 芬 盆 苯 甭 汾 摁 妊 蒽
晨	产 称 陈 沉 针 尘 辰 臣 趁 衬 肾 唇 帧 澈 忱
吴	无 务 物 午 舞 误 屋 污 乌 伍 雾 呜 勿 吾 巫
卷	短 检 健 软 监 端 圈 捐 劵 倦 娟 眷 柬 嬛 辕
贸	马 毛 猫 貌 冒 矛 妖 炮 涛 迈 烤 帽 茅 燥 冇
宇	于 预 遇 域 余 雨 愉 郁 愚 寓 逾 瑜 舆 榆 俞
闭	比 笔 币 逼 避 彼 壁 碧 鄙 弊 辟 臂 蔽 屄 庇
幼	有 又 游 优 油 右 邮 尤 忧 幽 悠 犹 诱 呦 佑
姓	行 性 向 星 形 型 兴 幸 醒 详 刑 祥 馨 杏 腥
虎	户 护 互 乎 湖 呼 胡 忽 糊 狐 沪 壶 蝴 葫 弧
抗	房 康 访 央 棒 狂 钢 矿 仰 旸 勘 纺 沧 扛 壤
予	于 预 遇 域 余 雨 宇 愉 郁 愚 寓 逾 瑜 舆 榆
腾	等 童 厅 灯 疼 唐 疯 崩 亭 彭 塘 泵 藤 蓬 耿
阴	因 音 银 引 印 隐 饮 姻 淫 瘾 吟 殷 尹 茵 荫
拟	你 际 尼 吉 紫 泥 逆 妮 埃 腻 伱 倪 霓 匿 昵
尾	位 微 味 卫 谓 慰 伪 胃 薇 韦 畏 惟 猥 萎 玮
屏	请 并 病 冰 兵 凌 饼 丙 泵 钉 莹 秉 柄 濒 炳
湿	什 实 市 师 试 世 视 式 使 失 识 示 士 适 饰
挥	回 惠 汇 慧 灰 辉 徽 毁 绘 恢 贿 讳 卉 晖 晦
冬	动 东 空 懂 灯 勇 宗 洞 董 冻 筒 栋 橙 澄 蓉
润	员 入 寻 滚 俊 辱 敦 棍 吞 蕴 仑 茹 峻 妊 遁
延	验 严 颜 炎 艳 燕 盐 岩 掩 宴 咽 衍 腌 堰 焉
傻	社 术 示 啥 杀 沙 烧 叔 删 厦 纱 莎 舌 砂 刹
齐	起 其 七 奇 汽 弃 妻 旗 骑 棋 契 岂 祈 琦 凄
顿	运 盾 敦 吨 棍 吞 蕴 妒 旬 沦 蹲 睹 囤 炖 钝
雄	想 行 型 兴 响 幸 乡 兄 姓 熊 刑 胸 囧 凶 巷
宗	重 总 空 懂 控 曾 综 宏 纵 泳 踪 涌 弘 巩 瞳
帖	且 姐 贴 铁 嚏 忒 惬 婕 涅 啼 忑 亵 缇 丿 镍
描	票 叫 效 料 跳 妙 秒 尿 乔 朴 娇 吊 孝 苗 喵
潮	号 超 操 朝 烧 炒 召 吵 浩 抄 嘲 阐 罩 巢 嚎
宿	诉 速 素 丝 私 苏 俗 塑 肃 妒 吾 舆 巫 辜 唔
津	进 金 今 音 近 尽 频 仅 紧 禁 劲 斤 锦 肩 谨
猪	助 祝 筑 逐 珠 诸 竹 驻 柱 煮 丶 烛 株 嘱 铸
貌	马 毛 猫 贸 冒 矛 妖 炮 烤 苗 帽 茅 冇 茂 髦
盟	等 更 梦 蒙 疯 萌 横 猛 孟 泵 蹭 懵 凳 瞪 檬
禁	进 金 今 音 近 尽 频 仅 紧 津 劲 斤 锦 肩 谨
毫	好 号 包 导 告 汉 豪 薄 澳 耗 浩 胞 嚎 昊 壕
饰	什 实 市 师 试 世 视 式 使 失 识 示 士 适 狮
艾	爱 批 哎 唉 碍 埃 欸 挨 哀 滋 晰 癌 矮 暧 惕
纠	就 九 价 究 酒 久 绩 救 旧 捷 忌 舅 揪 玖 韭
涉	师 设 社 属 核 摄 舍 射 鼠 蛇 奢 舌 誓 薯 慑
隐	因 音 银 引 印 阴 饮 姻 淫 瘾 吟 殷 尹 颐 茵
咯	哈 科 卡 亚 怕 苦 咖 渴 壳 涯 砸 祂 啪 慨 哑
屋	无 务 物 午 舞 误 污 乌 伍 雾 呜 勿 吾 巫 坞
嘿	内 非 黑 谓 悔 啡 胃 贺 磊 畏 禾 嗨 鹤 酶 贿
孙	员 诉 随 苏 尊 损 伦 混 塑 允 敦 逊 裙 匀 稣
欲	于 预 遇 域 余 雨 宇 愉 郁 愚 寓 逾 瑜 舆 榆
填	天 钱 坚 篇 田 仙 甜 添 殿 纤 勉 宪 舔 恬 惦
促	顾 族 舞 鱼 粗 崔 逾 瑜 芦 凸 醋 妒 吾 舆 巫
宫	工 公 功 共 供 控 攻 宗 贡 恭 讼 庚 巩 弓 咚
席	西 喜 息 吸 惜 悉 媳 晰 夕 锡 兮 茜 隙 玺 烯
逐	助 祝 筑 猪 珠 诸 竹 驻 柱 煮 丶 烛 株 嘱 铸
距	车 局 句 举 俱 惧 矩 菊 焗 橘 狙 鞠 驹 沮 钜
仔	自 子 资 字 咨 紫 姿 滋 兹 孜 籽 淄 梓 疵 呲
幅	福 付 负 富 夫 副 符 肤 傅 伏 覆 赋 腹 赴 辐
疼	等 童 厅 灯 腾 唐 疯 亭 彭 塘 泵 藤 蓬 耿 憎
狮	什 实 市 师 试 世 视 式 使 失 识 示 士 适 饰
俩	联 夏 裂 黎 夹 邻 莲 腊 榴 栗 洽 喇 硫 帘 颊
迹	己 机 集 击 激 吉 辑 既 寂 忌 稽 饥 姬 嫉 脊
锅	国 过 果 规 郭 扩 洛 措 滚 稿 惑 裹 撮 咕 呱
仁	人 分 本 然 文 问 认 任 温 忍 仍 愤 吻 芬 韧
梅	没 美 每 北 培 妹 媒 秘 煤 魅 眉 玫 霉 枚 昧
仙	现 先 限 县 鲜 献 闲 陷 嫌 贤 羡 宪 咸 掀 衔
债	指 支 站 择 致 追 址 灾 拆 宅 摘 诈 寨 兆 罩
奏	走 周 楼 优 住 投 油 欧 竹 诱 猴 兜 驻 抖 揍
督	都 度 读 独 毒 堆 盾 吐 裤 杜 赌 肚 渡 堵 妒
耐	能 男 白 难 台 南 奶 盖 奈 挨 哀 恼 乃 亥 暧
嘻	西 喜 息 吸 惜 悉 媳 晰 夕 锡 兮 茜 隙 玺 烯
皇	黄 幻 荒 凰 谎 慌 煌 晃 恍 焕 桓 惶 簧 潢 眶
烧	少 超 绍 朝 炒 稍 闪 召 吵 兆 擅 邵 汕 哨 皓
丹	但 单 担 餐 汉 倒 蛋 淡 旦 胆 诞 耽 氮 郸 惮
丢	第 求 流 酒 独 久 旧 毒 抵 痘 溜 舅 袖 蝶 丘
羊	样 房 望 养 阳 杨 央 洋 扬 仰 氧 旸 痒 妄 烊
拼	品 今 片 音 尽 频 临 贫 淋 潘 匹 鑫 叛 钦 擒
鼻	比 笔 币 逼 避 彼 壁 碧 鄙 弊 辟 臂 蔽 屄 庇
寄	己 机 集 击 激 吉 辑 既 寂 忌 稽 饥 姬 嫉 脊
娱	于 预 遇 域 余 雨 宇 愉 郁 愚 寓 逾 瑜 舆 榆
姑	股 故 古 顾 估 鼓 固 骨 孤 谷 雇 辜 菇 咕 沽
偿	产 场 常 唱 伤 厂 昌 尝 畅 肠 苍 倡 敞 铲 漳
菲	费 非 份 飞 肥 废 氛 啡 肺 妃 匪 沸 绯 酚 翡
磨	模 默 魔 末 摩 莫 摸 膜 墨 陌 脉 寞 抹 漠 沫
冠	关 管 观 官 软 馆 惯 钻 贯 灌 莞 罐 棺 纶 竿
链	联 连 简 练 恋 脸 炼 怜 莲 廉 辽 帘 敛 斓 镰
肤	福 付 负 富 夫 副 符 傅 伏 覆 赋 腹 赴 辐 缚
劲	进 金 今 音 近 尽 仅 紧 津 禁 斤 锦 肩 谨 晋
乘	成 程 城 充 声 承 诚 盛 撑 呈 肠 秤 惩 甸 敞
叔	数 术 熟 述 输 树 殊 暑 鼠 署 疏 蔬 梳 淑 抒
谷	股 故 顾 估 鼓 固 骨 孤 姑 雇 辜 菇 咕 沽 箍
摆	百 办 孩 北 带 白 排 板 拍 拜 败 泰 柏 卑 碍
岗	房 刚 阳 往 港 钢 扬 抗 仰 郎 汪 苍 纲 杠 烫
绪	需 许 续 须 序 雪 虚 徐 蓄 叙 旭 畜 絮 恤 婿
捕	不 部 步 补 布 苦 播 负 污 谱 怖 卜 埠 簿 哺
蒙	等 更 梦 腾 盟 疯 萌 猛 孟 蹦 泵 蹭 懵 绷 凳
甜	天 钱 坚 篇 田 填 仙 添 殿 纤 勉 宪 舔 恬 惦
扯	河 陈 彻 撤 吓 尘 尺 厨 澈 嗤 蔗 褚 忱 琛 宸
昌	场 常 唱 伤 厂 偿 尝 崇 畅 肠 秤 倡 敞 铲 漳
琴	气 轻 勤 侵 秦 漆 寝 钦 禽 茵 沁 芹 擒 槿 矜
郑	真 种 正 证 政 整 争 征 症 挣 帐 蒸 拯 睁 筝
珠	助 祝 筑 猪 逐 竹 驻 柱 煮 丶 烛 株 嘱 铸 诛
酸	欢 管 算 款 园 短 怨 闪 泉 钻 玄 犬 劵 袁 莞
删	神 山 善 闪 厦 扇 陕 擅 衫 珊 杉 筛 蒜 汕 姗
籍	计 级 及 集 即 急 吉 既 剂 寂 挤 脊 羁 藉 棘
抵	地 第 低 底 弟 递 帝 滴 迪 敌 蒂 堤 笛 旳 缔
旗	起 其 七 奇 汽 弃 妻 骑 棋 契 岂 祈 琦 凄 脐
剑	间 件 简 监 减 荐 键 兼 践 鉴 浅 剪 艰 肩 奸
唐	望 挺 堂 糖 汤 脏 躺 塘 趟 烫 氓 棠 倘 淌 膛
船	换 穿 川 患 窗 缓 串 缠 唇 阐 馋 撰 喘 桓 篡
染	然 玩 兰 胆 甘 曼 胖 燃 肝 翰 澜 罕 潭 壤 冉
慧	会 回 惠 汇 挥 灰 悔 辉 徽 毁 绘 恢 贿 讳 卉
薄	保 报 号 办 包 宝 抱 爆 暴 饱 堡 遥 剥 胞 曝
疯	更 风 丰 封 峰 凤 锋 奉 缝 蜂 冯 逢 讽 枫 绷
锁	所 索 缩 拖 扩 碎 扫 朵 螺 囖 琐 梭 嗦 搓 隧
暂	站 早 案 造 参 战 赞 凡 咱 宰 哉 砍 攒 蔓 淹
瓶	平 评 轻 兴 订 兵 迎 聘 凭 苹 棚 萍 坪 擎 乒
厉	理 里 力 利 立 历 礼 例 丽 励 莉 隶 哩 漓 篱
俗	诉 速 素 丝 熟 舞 苏 宿 塑 肃 舆 巫 辜 唔 尉
隔	个 格 歌 各 哥 革 割 戈 葛 鸽 阁 搁 冶 棵 褐
悉	西 喜 息 希 吸 惜 媳 晰 夕 锡 兮 隙 玺 烯 嬉
摇	要 约 药 邀 腰 妖 耀 遥 咬 谣 岆 瑶 姚 钥 叨
哲	这 着 者 至 折 喆 浙 竹 蛇 枝 振 赫 遮 辙 褶
潜	前 千 签 迁 欠 牵 谦 遣 铅 乾 倩 嵌 谴 黔 钳
尝	产 场 常 唱 伤 厂 偿 乘 昌 崇 畅 肠 倡 敞 漳
截	接 结 姐 介 街 借 阶 杰 洁 揭 戒 劫 羯 桔 诫
敏	民 蛮 邻 淋 闽 旻 闵 悯 鳞 忻 谩 矜 泯 胤 腼
庄	专 装 张 双 状 涨 皇 妆 撞 壮 荒 凰 谎 慌 胀
兼	间 件 简 监 减 荐 键 剑 践 鉴 浅 剪 艰 肩 奸
赔	配 委 培 卫 悲 贝 陪 菲 佩 霉 畏 沛 炜 徘 呸
赵	找 照 早 招 占 桌 遭 召 躁 粘 兆 罩 燥 昭 爪
罚	发 法 服 亚 怕 饭 附 乏 伏 覆 伐 砸 祂 阀 哑
徐	需 许 续 须 序 雪 虚 绪 蓄 叙 旭 畜 絮 恤 婿
泡	跑 奥 邀 逃 稿 扰 耗 炮 抛 啪 膏 稻 苞 袍 珀
迁	前 钱 千 签 潜 欠 歉 谦 遣 铅 乾 倩 嵌 谴 黔
跨	化 快 卡 华 划 苦 哭 酷 滑 咖 夸 昆 愧 卦 垮
坛	眼 谈 弹 探 湾 蓝 坦 摊 贪 叹 埋 俺 碳 滩 炭
丑	出 后 手 处 州 初 售 抽 厚 筹 臭 酬 愁 猴 宙
祖	组 续 局 足 族 租 哭 筑 紫 铺 阻 卜 炉 尉 牡
薪	心 新 信 形 您 欣 辛 嘻 拼 芯 鑫 腺 彬 懈 膝
倍	费 北 备 背 卫 悲 贝 违 辈 杯 呗 碑 卑 薇 佰
忧	又 游 优 油 右 邮 尤 幼 幽 悠 犹 诱 呦 佑 酉
废	费 非 备 飞 贝 肥 菲 啡 肺 妃 匪 沸 绯 翡 斐
鲁	路 录 陆 绿 鹿 炉 碌 撸 芦 璐 卤 禄 噜 泸 虏
穷	情 请 强 清 青 庆 熊 倾 胸 凶 晴 腔 琼 卿 呛
症	真 种 正 证 政 整 争 征 障 郑 挣 帐 蒸 拯 睁
纷	分 认 门 份 飞 粉 凡 奋 笨 纹 氛 愤 芬 逢 匪
践	件 建 简 检 荐 键 渐 剑 兼 鉴 尖 浅 艰 肩 舰
忽	户 护 互 乎 湖 呼 虎 糊 狐 沪 壶 蝴 葫 弧 唬
孕	员 运 言 云 允 晕 韵 蕴 匀 芸 酝 耘 陨 昀 熨
储	出 吃 处 初 除 楚 础 触 厨 丶 橱 雏 锄 孰 矗
拒	车 局 居 举 巨 聚 距 俱 惧 矩 菊 橘 狙 驹 沮
澳	案 造 奥 傲 熬 凹 漠 瑶 敖 嗷 袄 菠 艹 蘑 懊
朗	放 龙 浪 洋 钢 隆 粮 狼 芳 郎 痒 沧 廊 镑 琅
趋	去 区 取 曲 趣 驱 屈 渠 娶 逾 菇 躯 佢 祛 蛆
娜	那 哪 哈 拿 码 亚 怕 纳 罚 涯 哒 呐 匿 噶 趴
仪	艺 依 亦 姨 翼 乙 抑 逸 疫 毅 溢 奕 弈 祎 蚁
塔	他 她 它 爸 呀 罚 踏 塌 祂 啪 疤 哑 靶 鸦 喇
灰	回 惠 汇 挥 慧 悔 辉 徽 毁 绘 恢 贿 讳 卉 晦
咋	直 查 插 召 扎 炸 渣 诈 柱 詹 挚 闸 榨 眨 乍
裁	才 带 吃 白 此 持 财 彩 材 采 菜 盖 哎 猜 欸
旦	但 单 担 严 餐 汉 翻 蛋 淡 丹 胆 诞 耽 氮 钝
幽	又 游 优 油 右 邮 尤 幼 忧 悠 犹 诱 呦 佑 酉
赖	来 代 再 害 莱 奈 璃 唻 歪 粒 沥 垒 吏 睐 岚
迟	吃 持 智 裁 池 尺 赤 痴 驰 齿 耻 斥 侈 翅 炽
苹	平 评 境 轻 兴 兵 迎 聘 凭 瓶 盈 棚 丙 萍 坪
熊	想 行 型 象 兴 响 幸 兄 姓 雄 刑 胸 囧 凶 巷
宾	音 近 边 版 避 欣 碧 滨 饼 辨 谨 斌 彬 尹 昕
搬	办 帮 班 版 半 般 板 担 伴 探 坛 颁 斑 扮 挽
霸	被 破 婆 摩 坡 噢 寞 抹 颇 泼 倭 渤 袍 珀 陂
君	军 均 损 伦 混 俊 允 锦 敦 菌 逊 裙 骏 峻 抉
妆	专 装 张 双 状 涨 皇 庄 撞 壮 荒 凰 谎 慌 胀
伊	艺 依 姨 翼 乙 抑 逸 疫 毅 溢 蛾 奕 夷 弈 祎
仓	让 场 从 藏 档 荡 邦 郎 苍 灿 趟 芒 沧 蚕 舱
冒	马 毛 猫 贸 貌 矛 妖 炮 涛 迈 烤 糟 帽 茅 冇
患	欢 换 环 幻 缓 涵 喊 汗 钻 唤 焕 桓 痪 寰 浣
寒	汉 韩 含 涵 喊 汗 憾 函 扇 撼 旱 晗 焊 翰 罕
碰	朋 曾 登 灯 聘 萌 凤 崩 捧 鹏 扔 彭 棚 蓬 膨
辆	两 量 讲 亮 练 恋 奖 良 令 梁 凉 粮 郎 谅 靓
彼	比 笔 币 逼 避 闭 壁 碧 鄙 弊 辟 臂 蔽 屄 庇
凯	开 太 待 卖 态 嘅 癌 堪 迈 烤 蔡 宰 慨 霾 歹
紫	自 子 资 字 咨 仔 姿 滋 兹 孜 籽 淄 梓 疵 呲
敌	地 第 低 底 弟 递 帝 滴 迪 抵 蒂 堤 笛 旳 缔
泥	你 尼 忆 吉 拟 逆 妮 埃 欸 腻 伱 倪 霓 匿 昵
亡	网 望 玩 帮 晚 王 往 忘 唐 旁 汤 仿 荡 旺 汪
猜	才 带 吃 白 此 持 财 彩 材 采 菜 哎 裁 欸 惨
萌	等 名 朋 梦 腾 盟 蒙 疯 猛 孟 泵 蹭 懵 绷 凳
倾	情 请 清 亲 评 青 轻 另 庆 订 抢 晴 寝 卿 擎
迅	论 训 询 寻 讯 循 昆 巡 逊 旬 勋 熏 驯 薰 陨
剩	生 成 证 身 神 声 省 争 升 征 尚 胜 圣 症 呈
悔	会 回 汇 挥 慧 灰 辉 徽 毁 绘 恢 贿 讳 晖 晦
浮	福 付 负 富 夫 副 符 肤 傅 伏 覆 赋 腹 赴 辐
缩	所 索 锁 拖 扩 碎 扫 朵 螺 囖 琐 梭 嗦 搓 隧
焦	交 较 叫 角 脚 缴 胶 娇 骄 椒 矫 搅 蕉 浇 轿
赢	应 影 英 营 硬 映 盈 婴 鹰 樱 莹 荧 蝇 萤 莺
衡	政 风 城 朋 疼 乘 蒙 郑 疯 恒 横 哼 彭 牲 惩
铺	母 普 固 呼 谱 扑 浦 匹 沪 募 披 葡 菩 埔 仆
瑞	回 规 随 贵 汇 归 若 弱 灰 柜 兑 跪 锐 龟 睿
刑	行 性 向 星 形 型 兴 幸 静 醒 姓 馨 杏 腥 鲸
替	体 题 提 徒 梯 踢 剔 漓 伺 唧 畸 惕 蹄 涕 剃
郭	国 过 果 规 锅 扩 洛 措 滚 稿 惑 裹 撮 咕 呱
吹	水 睡 惠 追 慧 储 绘 痴 斥 蠢 垂 锤 翅 缀 炊
妙	票 叫 效 跳 描 秒 尿 乔 朴 娇 吊 孝 苗 喵 庙
蜜	米 密 迷 尼 嚒 秘 弥 咪 谜 幂 泌 靡 觅 眯 糜
腿	规 推 队 态 退 跪 桂 闺 屠 苔 圭 窥 秃 颓 蜕
硕	水 或 书 伙 束 树 舒 梳 戳 淑 梭 抒 赎 朔 烁
饮	因 音 银 引 印 阴 隐 姻 淫 瘾 吟 殷 尹 昕 茵
彻	河 陈 扯 撤 吓 尘 尺 厨 澈 嗤 蔗 褚 忱 琛 宸
伯	博 播 笔 波 闭 卧 拨 玻 勃 鄙 搏 泊 驳 脖 渤
勤	气 奇 林 琴 侵 秦 筋 寝 擎 钦 禽 囚 沁 芹 擒
滑	话 化 花 华 换 画 划 乎 惠 伙 魂 缓 哗 讳 焕
傲	案 造 奥 泡 澳 熬 凹 漠 瑶 敖 嗷 袄 艹 藻 懊
洞	动 东 农 懂 痛 弄 冬 宗 董 浓 贡 冻 庸 桶 栋
梁	两 量 讲 亮 练 奖 良 令 辆 凉 粮 莲 谅 靓 晾
莱	来 代 再 害 赖 璃 唻 歪 粒 沥 垒 吏 睐 岚 榄
凉	两 量 讲 亮 练 奖 良 令 辆 梁 粮 莲 谅 靓 晾
戴	代 带 导 台 待 嘚 贷 哎 搭 呆 袋 哀 栽 歹 黛
糖	挺 堂 唐 汤 狼 芳 脏 躺 塘 趟 烫 冈 棠 倘 淌
鸟	教 条 挑 缴 漂 胶 尿 萧 矫 嚣 渺 婊 廖 刁 侥
繁	万 反 饭 范 翻 烦 犯 凡 胆 返 泛 番 伐 帆 贩
玛	吗 妈 马 满 码 嘛 麻 秘 骂 摩 牙 贸 寞 抹 牧
旁	放 养 阳 往 凭 挡 苍 膀 棚 庞 磅 舱 扛 傍 澎
麦	买 该 每 孩 待 卖 态 嘛 毛 拜 败 猫 蜜 莱 戴
液	也 业 夜 爷 野 页 叶 泽 耶 曰 椰 冶 噎 烨 琊
窗	常 装 创 床 凰 谎 慌 倡 霜 闯 煌 晃 桩 敞 恍
摸	模 默 魔 末 摩 莫 磨 膜 墨 陌 脉 寞 抹 漠 沫
凤	更 风 丰 封 峰 蒙 疯 锋 奉 缝 蜂 冯 逢 讽 枫
蛮	满 谈 慢 漫 兰 贸 曼 番 炎 埋 谭 衍 茂 瞒 蔓
堆	对 度 第 队 底 岁 贷 递 碎 轨 催 兑 桂 敦 硅
鉴	件 建 简 检 荐 键 渐 剑 兼 践 尖 浅 艰 肩 舰
娃	完 万 亚 怕 爸 挖 哇 瓦 勿 挽 啪 袜 靶 鸦 蜗
爽	装 伤 双 尚 床 赏 皇 妆 凰 谎 慌 霜 疮 幢 惶
刊	看 男 难 颜 咱 惨 摊 盐 堪 砍 坎 侃 勘 衍 晗
辞	次 此 词 急 笔 益 依 礼 材 刺 剂 磁 慈 瓷 赐
汤	堂 唐 糖 仰 躺 塘 趟 旸 碳 烫 壤 毯 棠 倘 淌
卧	我 无 握 窝 污 沃 涡 喔 勃 倭 蜗 茉 鳌 鹉 莴
胎	太 代 再 该 台 态 泰 替 腿 梯 涛 迈 抬 汰 苔
森	本 文 问 怎 门 根 闻 审 奋 奔 孙 纷 氛 嫩 肾
盾	运 顿 敦 吨 棍 吞 蕴 妒 旬 沦 蹲 睹 囤 炖 钝
悠	有 友 又 游 由 优 油 右 邮 尤 幼 幽 犹 诱 呦
胆	但 单 担 严 餐 蛋 淡 丹 旦 诞 汗 耽 氮 钝 郸
浙	这 着 者 查 至 折 喆 哲 竹 蛇 枝 振 赫 遮 辙
甘	感 万 跟 干 敢 赶 残 憾 贪 杆 肝 尴 扳 嘎 赣
炒	号 照 超 差 朝 潮 烧 赵 吵 耗 抄 缠 嘲 罩 巢
撤	河 陈 扯 彻 吓 尘 尺 厨 澈 嗤 蔗 褚 忱 琛 宸
枪	强 象 签 良 抢 潜 迁 墙 腔 浆 靓 呛 钳 蔷 锵
阵	真 镇 针 珍 圳 震 诊 振 侦 贞 甄 枕 帧 疹 臻
吐	图 足 句 土 突 途 宿 屋 欲 促 徒 兔 涂 叙 愈
聪	东 从 综 勇 铜 苍 泳 葱 匆 丛 雍 耸 珑 咙 冗
筹	出 后 手 处 州 抽 厚 丑 臭 酬 愁 猴 宙 轴 粥
柔	友 候 入 楼 油 购 欧 肉 幽 悠 猴 兜 佑 喉 揉
柜	该 规 贵 归 鬼 轨 醉 跪 瑰 桂 闺 龟 硅 卦 诡
姻	因 音 易 义 银 引 印 阴 隐 饮 淫 瘾 吟 殷 尹
池	直 吃 持 迟 尺 赤 痴 驰 齿 耻 斥 侈 翅 炽 嗤
曼	男 满 谈 慢 漫 兰 蛮 番 炎 埋 谭 衍 茂 瞒 蔓
踏	他 她 它 爸 呀 罚 塔 塌 祂 啪 疤 哑 靶 蹄 喀
辅	福 付 富 府 夫 妇 副 符 幅 肤 傅 覆 赋 赴 辐
植	知 只 直 至 指 支 置 止 织 纸 枝 脂 汁 吱 肢
盗	到 道 导 答 药 倒 岛 刀 蹈 谣 骚 雕 岆 瑶 稻
胖	盘 谈 范 慢 频 判 盼 潘 叛 攀 贩 炭 滥 婉 帕
拖	活 左 突 罗 托 脱 逃 徒 拓 妥 螺 吞 魄 陀 驼
窝	我 无 握 卧 污 膜 沃 涡 喔 勃 倭 蜗 鹉 莴 龌
亏	快 腿 馈 愧 溃 摧 葵 窥 盔 魁 奎 匮 悴 睢 傀
魂	论 婚 护 混 虎 挥 润 憾 晕 昆 沪 浑 昏 匀 捆
污	无 务 物 午 舞 误 屋 乌 伍 雾 呜 勿 吾 巫 坞
揭	结 节 界 姐 介 街 借 阶 洁 截 捷 劫 羯 桔 诫
扩	错 靠 罗 坐 括 缩 郭 拖 亏 措 裸 阔 琐 枯 坤
盒	和 合 何 呵 河 核 喝 荷 吓 赫 贺 阁 禾 嗨 鹤
恒	政 风 城 朋 疼 乘 蒙 郑 疯 衡 横 哼 彭 牲 惩
拆	海 孩 差 材 裁 迟 炒 宅 赤 柴 阐 侈 锤 亥 钞
泽	字 客 课 哥 则 责 紫 液 冶 棵 褐 啧 孜 仄 靥
械	些 解 谢 写 协 鞋 邪 谐 蟹 携 泄 蝎 歇 卸 胁
尸	什 实 师 试 世 视 式 使 失 识 示 士 适 饰 驶
仿	方 让 放 房 防 藏 访 央 棒 杭 泛 芳 坊 妨 纺
呆	代 带 导 改 待 嘚 贷 哎 搭 戴 袋 哀 栽 歹 黛
坑	等 更 曾 康 嗡 登 腾 盟 疼 蒙 疯 衡 缝 蜂 梗
殊	书 术 属 述 输 树 舒 叔 暑 鼠 署 疏 蔬 抒 赎
睛	经 精 京 境 景 竟 竞 镜 净 敬 径 晶 颈 殑 荆
辉	会 回 惠 汇 挥 慧 灰 徽 毁 绘 恢 贿 讳 卉 晦
邀	要 约 药 奥 摇 腰 妖 耀 遥 咬 谣 岆 瑶 姚 钥
厌	验 严 颜 炎 艳 燕 盐 岩 掩 宴 咽 衍 腌 堰 焉
谱	母 故 普 固 幕 铺 扑 浦 匹 募 披 葡 菩 埔 仆
崇	成 重 程 充 承 冲 诚 聪 忠 虫 宏 宠 仲 肿 衷
挖	完 怕 爸 握 罚 娃 哇 瓦 砸 挽 啪 袜 顽 靶 鸦
逃	套 络 搞 讨 淘 桃 陶 叹 胞 熬 涛 瑶 萄 掏 陀
驶	什 实 市 师 试 世 视 式 使 失 识 示 士 适 饰
拔	吧 八 把 步 拿 爸 巴 娃 芭 罢 叭 疤 坝 靶 屄
洛	活 或 落 罗 逻 裸 啰 萝 堕 螺 囖 撸 卤 懦 烙
煤	没 美 每 委 妹 媒 梅 魅 慰 眉 玫 魏 霉 枚 昧
缓	欢 换 环 幻 患 魂 涵 喊 汗 钻 唤 焕 桓 痪 寰
墙	强 象 签 良 箱 抢 潜 迁 枪 腔 浆 靓 呛 晾 钳
炼	联 连 简 练 恋 脸 链 怜 莲 廉 羡 帘 敛 斓 镰
坦	眼 案 谈 弹 探 湾 蓝 坛 摊 贪 叹 俺 碳 滩 炭
返	男 万 反 饭 范 翻 烦 犯 凡 繁 胆 甘 泛 番 帆
恨	很 深 份 喷 喊 吓 哼 闷 笨 汗 纹 尘 狠 痕 雯
塞	海 孩 试 世 载 赛 散 盖 尸 呆 碍 拾 乃 筛 逮
措	错 诺 催 寸 挫 萝 搓 惰 摧 驼 骆 灬 萃 簇 磋
贫	品 片 音 尽 频 临 拼 淋 潘 匹 鑫 叛 钦 沁 吝
悟	无 务 物 午 舞 误 吴 屋 污 乌 伍 雾 呜 勿 吾
迫	牌 排 拍 嘚 培 概 采 批 皮 跑 菜 嘅 奶 派 沛
滚	故 军 冠 灌 浑 雇 昏 坤 硅 罐 刮 吨 棍 卦 吞
乏	发 法 服 亚 怕 饭 附 罚 伏 覆 涯 伐 祂 阀 哑
秒	票 叫 效 跳 描 妙 尿 乔 朴 娇 吊 孝 苗 喵 庙
荡	当 房 党 榜 档 唐 昂 挡 妨 纺 庞 橙 瞪 壤 莽
览	担 络 兰 蓝 烂 懒 篮 栏 滥 谭 衍 攒 拦 翰 澜
桌	活 住 货 抓 著 朱 卓 捉 兆 拙 灼 浊 绰 酌 镯
锋	更 风 丰 封 峰 蒙 疯 凤 奉 缝 蜂 冯 逢 讽 枫
烂	担 络 兰 蓝 览 懒 篮 栏 滥 谭 衍 攒 拦 翰 澜
邦	让 帮 班 病 航 榜 杨 棒 绑 斑 桑 膀 镑 秧 嚷
遭	早 造 左 貌 毫 槽 抛 栽 绕 熬 糟 躁 澡 膏 燥
稿	高 告 干 搞 闹 貌 糕 桃 陶 帽 曹 膏 茂 镐 袍
哇	完 怕 爸 罚 娃 挖 瓦 砸 勿 挽 啪 袜 靶 鸦 蛙
逆	你 尼 忆 拟 泥 妮 埃 欸 腻 伱 倪 霓 匿 昵 幂
惑	活 或 货 火 获 昨 伙 拖 魂 霍 祸 豁 剁 壕 灬
忠	中 种 重 证 张 充 终 众 钟 掌 账 仲 肿 衷 蒸
欠	前 钱 千 签 潜 迁 牵 谦 遣 铅 乾 倩 嵌 谴 黔
膜	模 默 魔 末 摩 莫 磨 摸 墨 陌 脉 寞 抹 漠 沫
怨	原 院 元 远 源 愿 缘 圆 援 袁 苑 冤 渊 媛 猿
垃	马 历 离 拉 啦 咯 俩 辣 炉 叻 梨 蜡 腊 喇 耙
稍	少 超 绍 朝 烧 硕 炒 闪 召 吵 兆 擅 邵 汕 哨
闪	山 善 删 汗 扇 陕 擅 衫 颤 珊 杉 汕 姗 煽 讪
呗	费 北 备 背 卫 悲 贝 违 辈 杯 倍 碑 卑 佰 沛
董	动 东 农 懂 痛 弄 冬 宗 洞 浓 贡 冻 庸 桶 栋
夺	多 读 货 队 朵 哆 躲 敦 萝 堕 裹 稻 捣 剁 惰
由	又 优 油 右 邮 尤 幼 忧 幽 悠 犹 诱 呦 佑 酉
召	找 照 造 招 债 赵 炒 吵 抄 糟 摘 兆 罩 昭 嚎
哟	游 预 遇 移 亚 爷 摩 牙 脉 遥 涡 抹 酉 逾 倭
壁	比 笔 币 逼 避 彼 碧 鄙 弊 辟 臂 蔽 屄 庇 哔
驱	去 区 取 曲 突 趣 趋 屈 渠 娶 芦 菇 躯 佢 祛
吵	号 照 超 差 朝 潮 烧 赵 炒 耗 抄 缠 嘲 罩 巢
颗	可 格 科 客 课 克 刻 渴 壳 柯 阁 磕 棵 苛 坷
径	经 精 京 境 景 竟 静 竞 镜 净 敬 睛 晶 颈 殑
荷	和 合 何 课 呵 河 核 喝 叶 盒 吓 赫 贺 禾 鹤
添	天 钱 坚 篇 田 填 仙 甜 殿 纤 勉 宪 舔 恬 惦
泉	全 权 券 幻 缘 圆 酸 潜 迁 患 劝 拳 悬 谦 锻
魅	没 美 每 妹 媒 梅 煤 慰 眉 玫 魏 霉 枚 昧 媚
虫	成 重 程 充 承 冲 诚 聪 崇 忠 宏 宠 仲 肿 衷
怒	付 足 句 努 屋 欲 促 距 幅 督 肤 豫 拘 喻 奴
乌	无 务 物 午 舞 误 吴 屋 污 伍 呜 勿 吾 巫 坞
耶	也 业 夜 爷 野 页 叶 液 曰 椰 冶 噎 讹 烨 琊
欺	起 其 七 汽 弃 妻 旗 骑 棋 契 岂 祈 琦 凄 祁
宏	容 红 杭 孔 宠 哼 浓 贡 洪 虹 鸿 轰 哄 弘 烘
颁	办 玩 帮 班 版 半 般 板 伴 探 坛 搬 斑 扮 疤
矿	广 款 况 黄 康 狂 皇 逛 框 凰 谎 旷 惶 匡 簧
拨	博 爸 播 笔 波 佛 伯 玻 勃 鄙 搏 泊 驳 脖 渤
挣	正 证 政 整 争 涨 征 震 郑 症 忠 肿 蒸 绳 甸
懒	担 络 兰 蓝 览 烂 篮 栏 滥 谭 衍 旱 攒 拦 澜
沃	我 误 握 卧 窝 污 挖 哇 涡 喔 颇 倭 蜗 蛙 捂
畅	场 常 唱 厂 偿 乘 昌 尝 崇 肠 胀 秤 倡 敞 铲
宋	红 共 送 供 融 松 踪 讼 轰 诵 颂 嵩 怂 耸 悚
诞	但 单 担 严 餐 汉 翻 蛋 淡 丹 旦 胆 耽 氮 钝
骑	起 其 七 汽 弃 妻 旗 棋 契 岂 祈 琦 凄 祁 脐
瓜	关 华 股 归 怪 挂 锅 谷 滚 瑰 龟 拐 硅 罐 刮
乂	艺 依 亦 姨 翼 乙 抑 逸 疫 毅 溢 奕 夷 弈 祎
横	政 风 城 朋 疼 乘 蒙 郑 疯 衡 恒 哼 彭 牲 惩
扰	导 告 澳 盗 邀 逃 遭 稿 耗 腰 绕 饶 郝 苞 皋
疾	计 级 及 集 即 急 激 吉 既 剂 寂 挤 脊 羁 藉
尖	件 建 简 检 荐 键 渐 剑 兼 践 浅 艰 肩 舰 箭
耗	好 号 导 告 搞 豪 毫 薄 澳 浩 胞 姥 嚎 昊 壕
碎	队 诉 随 适 岁 虽 屎 髓 遂 圭 窥 嘶 矢 隧 穗
陷	现 先 限 险 县 鲜 献 闲 仙 嫌 羡 宪 咸 掀 衔
亦	艺 依 姨 翼 乙 抑 逸 疫 毅 溢 奕 夷 弈 祎 沂
唉	爱 细 哎 艾 亦 柏 碍 埃 欸 挨 哀 癌 俺 凹 矮
沈	身 设 神 深 申 审 甚 珍 伸 慎 痕 肾 渗 绅 婶
撑	成 程 城 充 声 承 诚 盛 乘 昌 呈 肠 秤 惩 甸
裤	股 步 组 苦 库 符 哭 酷 赋 枯 缚 埔 溯 窟 煜
侠	下 谢 细 夏 瞎 霞 虾 辖 锡 袖 峡 狭 暇 瑕 朽
辩	变 边 编 减 荐 遍 辨 贬 纤 弦 勉 宪 煎 捡 鞭
柏	百 办 孩 北 白 排 板 拍 奶 拜 败 泰 摆 卑 碍
圾	计 级 及 集 即 急 激 吉 既 剂 寂 挤 脊 羁 藉
晶	经 精 京 境 景 竟 静 竞 镜 净 敬 睛 径 颈 殑
辣	马 历 离 拉 啦 俩 垃 叻 梨 蜡 腊 喇 耙 庐 咔
悦	月 觉 与 越 绝 阅 宇 予 跃 羽 岳 玥 渔 粤 曰
袋	代 带 改 待 嘚 贷 哎 戴 呆 哀 栽 歹 黛 亥 暧
腰	要 约 药 摇 邀 妖 耀 遥 咬 谣 岆 瑶 姚 钥 吖
徒	图 足 句 录 土 突 途 宿 屋 欲 促 吐 兔 涂 叙
绑	让 帮 班 病 航 榜 杨 棒 邦 斑 桑 膀 镑 秧 嚷
胸	想 行 相 向 型 象 项 乡 箱 兄 雄 穷 熊 馨 湘
矛	包 毛 猫 贸 貌 冒 浩 帽 茅 冇 茂 昊 噪 韬 髦
井	经 精 京 境 警 竟 静 竞 镜 净 敬 睛 径 殑 荆
轨	该 规 贵 归 鬼 柜 毁 醉 跪 瑰 桂 闺 龟 硅 卦
犹	有 友 又 游 由 优 油 右 邮 尤 幼 悠 诱 呦 佑
胶	交 较 叫 角 脚 缴 焦 娇 骄 椒 矫 搅 蕉 浇 轿
朱	主 注 住 助 筑 猪 逐 诸 驻 柱 煮 丶 烛 嘱 铸
捷	接 结 节 姐 介 街 借 阶 杰 洁 截 揭 劫 羯 桔
嫌	现 先 限 险 县 鲜 献 闲 仙 陷 羡 宪 咸 掀 衔
王	网 望 玩 帮 往 忘 亡 旁 汤 仿 荡 旺 汪 妄 葬
帐	长 重 张 唱 章 争 厂 掌 账 涨 障 丈 胀 仗 颤
扎	直 查 插 咋 炸 渣 诈 詹 挚 闸 榨 眨 乍 诧 炙
杭	刚 航 畅 横 绑 帐 涵 喊 哼 汗 仰 磅 缸 枉 嗓
撒	马 死 骂 傻 宿 咯 萨 尬 呐 寺 洒 刹 咔 粑 嘶
灭	谢 节 憋 蝶 咪 胁 羯 碟 捏 谜 咧 竭 咩 蔑 镊
孔	东 从 空 控 融 康 勇 恐 庸 泳 诵 蓉 颂 绒 弘
俊	军 均 尊 损 伦 混 君 允 锦 菌 逊 裙 骏 峻 抉
徽	回 惠 汇 挥 慧 灰 辉 毁 绘 恢 贿 讳 卉 晖 晦
涵	汉 韩 含 寒 喊 汗 憾 函 扇 撼 旱 晗 焊 翰 罕
毁	回 惠 汇 挥 慧 灰 辉 徽 绘 恢 贿 讳 卉 晖 晦
誉	于 预 遇 域 余 雨 宇 愉 郁 愚 寓 逾 瑜 舆 榆
喷	品 任 闻 奋 奔 拼 赔 纷 佩 氛 狠 愤 盆 棚 粪
宠	成 重 程 充 承 冲 诚 聪 崇 忠 虫 宏 仲 肿 衷
醉	最 质 值 字 昨 纸 罪 嘴 碎 轨 旨 愧 贿 咀 赘
氏	十 事 实 市 试 使 失 识 石 势 室 诗 湿 饰 狮
腐	服 复 负 妇 浮 伏 覆 赋 抚 腹 赴 敷 辐 缚 阜
喊	汉 韩 含 寒 涵 汗 憾 函 扇 撼 旱 晗 焊 翰 罕
吓	和 合 何 课 呵 河 核 喝 呼 射 隔 盒 荷 赫 贺
诸	主 注 住 助 筑 猪 逐 朱 驻 柱 煮 丶 烛 嘱 铸
李	理 里 力 利 立 礼 例 丽 励 莉 隶 哩 漓 犁 鲤
姨	艺 依 亦 翼 乙 抑 逸 疫 毅 溢 奕 弈 祎 蚁 沂
兔	图 足 句 土 突 途 宿 屋 欲 促 吐 徒 涂 叙 愈
戒	接 结 节 界 姐 介 街 借 阶 杰 洁 截 揭 劫 羯
篮	范 担 络 兰 蓝 览 烂 懒 栏 滥 谭 攒 拦 澜 罕
俄	哦 额 恶 饿 鹅 噩 厄 鄂 遏 讹 扼 胺 峨 鳄 愕
斑	办 反 玩 帮 班 版 半 般 板 伴 探 坛 搬 颁 扮
剂	计 级 及 集 即 积 急 激 继 鸡 吉 挤 姬 羁 畸
呃	哦 额 恶 俄 饿 鹅 噩 厄 鄂 遏 娥 讹 扼 胺 峨
哼	政 风 城 朋 疼 乘 蒙 郑 疯 衡 恒 横 彭 牲 惩
糕	高 告 络 搞 稿 槽 耀 饱 陶 裹 膏 镐 丐 皋 柑
扫	号 包 赛 刀 散 淘 盗 邀 剥 曝 骚 嫂 冇 嚎 叁
泛	万 反 饭 范 翻 烦 犯 凡 繁 胆 返 番 伐 帆 贩
岸	安 完 班 干 演 案 按 兰 暗 胆 甘 俺 氨 鞍 揽
闷	们 每 认 民 门 笨 纹 眉 玫 枚 蚊 檬 焖 朦 旻
扶	服 复 负 妇 浮 伏 覆 赋 抚 腹 赴 敷 辐 缚 阜
凌	零 领 兴 另 灵 令 龄 玲 铃 陵 岭 菱 聆 伶 拎
寿	手 收 书 受 首 售 洲 守 搜 授 丑 筹 兽 瘦 愁
斤	进 金 今 近 尽 坚 仅 紧 阴 津 禁 劲 锦 滨 谨
粗	顾 族 舞 鱼 促 崔 逾 瑜 芦 凸 醋 妒 吾 舆 巫
糊	户 护 互 乎 湖 呼 胡 虎 忽 狐 沪 壶 蝴 葫 弧
擦	此 亚 怕 彩 爸 厕 罚 娜 涯 哒 疤 坝 灿 喇 蛤
笨	本 认 班 悲 奔 呗 颁 滨 芬 盆 苯 甭 汾 惫 蓓
屈	去 区 取 曲 趣 趋 驱 渠 娶 凸 醋 渝 菇 躯 佢
绘	回 惠 汇 挥 慧 灰 辉 徽 毁 恢 贿 讳 卉 晦 荟
邪	些 解 谢 写 协 鞋 械 谐 蟹 携 泄 蝎 歇 卸 胁
阻	组 续 局 足 族 租 筑 祖 紫 铺 卜 炉 募 尉 牡
磁	次 此 词 急 笔 益 依 礼 刺 辞 唉 慈 瓷 赐 茨
割	个 格 歌 各 哥 革 谷 隔 戈 葛 鸽 阁 搁 冶 菇
汗	汉 韩 含 寒 涵 喊 憾 函 扇 撼 旱 晗 焊 翰 罕
此	次 词 急 笔 礼 击 材 刺 辞 圾 磁 慈 瓷 赐 茨
墨	默 魔 末 摩 莫 磨 摸 膜 陌 脉 寞 抹 漠 沫 麽
羞	续 戏 修 秀 休 袖 绣 斜 瘤 玖 狭 畜 絮 锈 朽
碑	费 北 备 背 卫 悲 贝 雷 违 辈 杯 倍 呗 卑 薇
逗	独 斗 欧 肉 豆 偷 忧 幽 犹 兜 抖 痘 钩 陡 窦
浅	件 建 简 检 坚 荐 键 渐 剑 践 鉴 尖 艰 肩 舰
慰	位 微 味 卫 谓 伪 胃 薇 魏 韦 畏 惟 猥 萎 玮
屁	被 批 皮 脾 疲 匹 啤 劈 癖 痞 坯 霹 琵 媲 丕
牵	前 钱 千 签 潜 迁 欠 谦 遣 铅 乾 嵌 谴 黔 钳
朵	多 读 货 队 夺 哆 躲 萝 堕 裹 稻 捣 剁 惰 舵
妮	你 尼 拟 敌 泥 逆 埃 欸 腻 伱 倪 霓 匿 昵 幂
愉	于 预 遇 域 余 雨 宇 郁 愚 寓 逾 瑜 舆 榆 俞
乳	如 入 故 诉 付 孤 吴 宇 虎 予 狱 腹 雾 辱 儒
兽	手 收 书 受 首 售 洲 守 搜 授 丑 筹 寿 瘦 愁
郁	于 预 遇 域 余 雨 宇 愉 愚 寓 逾 瑜 舆 榆 俞
肌	己 计 级 及 集 即 积 急 激 鸡 吉 剂 挤 祭 姬
厦	失 识 啥 杀 沙 傻 晒 蛇 纱 莎 屎 扇 叉 疏 洒
奈	能 白 难 台 南 奶 盖 耐 挨 哀 恼 癌 乃 亥 暧
浩	好 号 导 告 汉 豪 毫 薄 澳 耗 胞 姥 嚎 昊 壕
纹	文 问 位 温 卫 粉 闻 稳 纷 吻 畏 挽 丸 雯 蚊
钻	管 院 算 展 短 圆 遵 悬 砖 锻 捐 娟 蒜 诠 崭
卑	费 北 备 背 卫 悲 贝 雷 违 辈 杯 倍 呗 碑 薇
前	钱 签 潜 迁 欠 牵 歉 遣 铅 乾 倩 嵌 谴 黔 钳
逻	活 或 落 罗 洛 裸 啰 萝 堕 螺 囖 撸 卤 烙 骆
翼	艺 依 亦 姨 乙 抑 逸 疫 毅 溢 奕 弈 祎 蚁 沂
仰	样 眼 养 阳 杨 央 洋 扬 羊 氧 旸 痒 烊 秧 漾
暑	书 属 述 输 束 树 舒 叔 殊 鼠 署 疏 蔬 抒 赎
塑	诉 速 素 丝 私 苏 宿 俗 肃 凸 妒 吾 舆 巫 辜
嫁	家 加 价 假 酒 佳 架 驾 甲 嘉 夹 贾 迦 钾 戛
谐	些 解 谢 写 协 鞋 械 邪 蟹 携 泄 蝎 歇 卸 胁
慕	目 母 句 码 木 幕 屋 欲 促 距 姆 寞 堵 寓 牧
抄	号 照 超 朝 潮 烧 赵 炒 吵 耗 缠 嘲 阐 罩 巢
盈	应 影 英 营 迎 硬 映 赢 颖 婴 鹰 樱 莹 荧 蝇
傅	服 付 父 富 府 附 妇 符 幅 肤 辅 抚 弗 辐 俯
允	员 运 言 云 阅 孕 晕 韵 蕴 匀 芸 酝 耘 陨 昀
姆	目 母 府 密 乎 舞 木 幕 慕 牧 墓 募 瑜 穆 畜
碍	爱 哎 艾 疾 亦 唉 埃 欸 挨 哀 癌 凹 矮 暧 漓
妖	要 约 药 讨 摇 邀 腰 耀 遥 咬 谣 岆 瑶 姚 钥
炮	跑 奥 泡 胖 邀 逃 遭 稿 扰 抛 啪 膏 稻 苞 袍
萨	把 达 马 阿 斯 素 嘛 咯 玛 踏 撒 洒 葩 涩 喇
埃	爱 细 哎 艾 疾 亦 唉 碍 欸 挨 哀 癌 凹 矮 暧
尘	称 陈 甚 沉 镇 晨 扯 撤 诊 辰 臣 趁 衬 秤 逞
欸	爱 细 哎 艾 疾 亦 唉 碍 埃 挨 哀 癌 凹 矮 暧
恰	钱 价 器 架 欠 骑 戚 棋 瞧 峡 寝 窃 洽 邱 翘
拾	十 事 什 实 市 试 失 识 适 势 室 释 饰 狮 尸
杜	都 度 读 独 顾 舞 毒 督 赌 肚 渡 堵 笛 妒 嘟
拓	推 讨 索 托 脱 锁 拖 妥 魄 陀 驼 唾 糯 灬 坨
渠	去 区 取 足 曲 趣 幅 趋 驱 屈 叙 愈 娶 躯 佢
瘦	手 收 书 受 首 售 洲 守 搜 授 筹 寿 兽 骤 蔬
桃	包 宝 套 讨 淘 逃 浩 妖 炮 陶 涛 萄 掏 谭 昊
逛	关 光 广 官 港 钢 荒 框 灌 罐 煌 晃 恍 棺 旷
槽	保 再 早 造 搞 倒 岛 盗 遭 抛 栽 牢 糟 躁 澡
谋	由 否 某 幕 厚 摩 沟 膜 喽 酉 喉 钩 牟 眸 疣
耀	要 约 药 讨 摇 邀 腰 妖 遥 咬 谣 岆 瑶 姚 钥
扮	办 反 玩 帮 班 版 半 般 板 伴 探 坛 搬 颁 斑
饱	保 报 包 宝 告 抱 爆 暴 薄 扰 堡 剥 胞 曝 钥
锦	进 金 今 音 近 尽 仅 紧 阴 津 禁 劲 斤 肩 谨
陶	包 宝 套 讨 淘 逃 浩 妖 炮 桃 涛 萄 掏 谭 昊
番	万 反 饭 范 翻 烦 犯 凡 繁 胆 返 泛 帆 贩 瞒
恢	会 回 惠 汇 挥 慧 徽 毁 贿 讳 晖 晦 荟 秽 烩
昂	让 安 王 嗯 忘 藏 堂 岗 唐 杭 坊 茫 盲 痒 沧
咖	哈 科 卡 克 亚 怕 苦 咯 渴 壳 涯 蜡 腊 祂 啪
侵	气 奇 林 琴 勤 秦 漆 寝 钦 禽 妾 沁 芹 擒 槿
跃	月 觉 与 越 阅 宇 予 悦 羽 岳 玥 渔 於 粤 曰
隆	领 龙 冬 宗 笼 佣 匆 栋 丛 垄 拢 珑 聋 胧 陇
挨	爱 细 哎 艾 疾 亦 唉 碍 埃 欸 哀 癌 凹 矮 暧
炸	直 查 插 咋 扎 渣 诈 詹 挚 闸 榨 眨 乍 诧 炙
粮	两 量 讲 亮 练 恋 奖 良 令 辆 梁 凉 郎 谅 靓
堡	保 报 包 宝 告 抱 爆 暴 薄 扰 饱 剥 胞 曝 钥
狼	浪 朗 仓 辆 荡 览 懒 郎 廊 澜 菱 磅 嗓 琅 梆
蹈	到 道 导 倒 岛 刀 澳 旦 冒 傲 戴 胆 盗 呆 邀
炎	验 严 颜 艳 燕 盐 沿 岩 掩 宴 咽 衍 腌 堰 焉
坡	被 破 婆 摩 霸 墨 寞 抹 颇 泼 倭 啤 袍 珀 陂
眉	没 美 位 每 米 妹 媒 梅 赔 废 煤 魅 玫 霉 枚
诊	真 镇 针 珍 圳 震 振 侦 贞 甄 枕 帧 疹 臻 朕
怜	联 连 简 练 恋 脸 链 炼 莲 廉 羡 帘 敛 斓 镰
押	亚 呀 压 雅 牙 涯 鸭 丫 吖 芽 讶 哑 鸦 崖 娅
赌	都 度 读 独 顾 舞 毒 督 杜 肚 渡 堵 笛 妒 嘟
媳	西 喜 习 吸 悉 晰 稀 溪 兮 茜 曦 犀 烯 嬉 羲
陌	模 默 魔 末 摩 磨 摸 膜 墨 脉 寞 抹 漠 沫 麽
芭	吧 八 把 步 拿 爸 巴 娃 拔 罢 叭 疤 坝 靶 屄
剪	见 简 检 坚 健 减 荐 键 践 鉴 尖 肩 舰 奸 牋
伪	位 微 味 卫 谓 慰 胃 薇 韦 畏 惟 猥 萎 玮 炜
漏	流 头 楼 录 露 豆 陆 扣 偶 搜 透 炉 喽 苟 陋
夸	话 化 快 困 咯 跨 滑 亏 扩 瓜 阔 哗 葵 垮 盔
惨	言 晚 眼 案 参 餐 湾 凡 残 堪 埋 俺 岩 碗 苍
鼠	书 术 属 述 树 舒 叔 殊 暑 署 疏 梳 抒 赎 薯
丈	长 重 张 章 争 厂 掌 账 涨 障 帐 胀 仗 颤 彰
裂	留 列 烈 猎 劣 咧 膊 戾 偕 秸 丿 镍 遴 砾 拮
秦	气 奇 林 琴 勤 侵 漆 寝 栖 钦 禽 沁 芹 擒 槿
佩	位 被 配 培 威 陪 赔 倍 废 玫 韦 匹 匪 惟 沛
撞	专 装 张 双 状 涨 皇 庄 妆 壮 荒 凰 谎 慌 胀
燃	然 玩 兰 染 胆 甘 曼 胖 肝 翰 澜 罕 潭 壤 冉
哀	爱 细 哎 艾 疾 亦 唉 碍 埃 欸 挨 癌 凹 矮 暧
罢	吧 八 把 哈 步 爸 巴 娃 拔 芭 叭 疤 坝 靶 蛤
尺	吃 持 迟 池 赤 痴 驰 齿 耻 斥 侈 翅 炽 嗤 褚
浓	总 农 童 拥 松 弄 隆 贡 佣 匆 栋 丛 垄 彤 拱
玫	没 美 内 买 位 每 米 妹 媒 梅 赔 煤 魅 眉 霉
晒	市 孩 试 世 视 式 山 啥 诗 宅 誓 衫 砂 嘘 刹
摊	谈 弹 探 湾 坛 坦 贪 叹 埋 碳 滩 炭 谭 潭 憨
催	队 退 瑞 吹 腿 脆 粹 翠 崔 怼 贿 摧 萃 荟 捶
寂	计 级 及 技 集 即 积 急 激 继 吉 辑 既 剂 挤
援	原 院 元 远 源 园 缘 圆 怨 袁 苑 冤 渊 媛 猿
黎	力 利 礼 例 莉 厘 隶 哩 荔 篱 鲤 俐 珞 戾 砾
芳	方 当 让 放 房 养 防 藏 访 央 棒 抗 旁 仿 坊
姿	自 子 资 字 咨 仔 紫 滋 兹 籽 淄 梓 疵 呲 渍
挤	计 级 及 技 集 即 积 急 激 继 吉 辑 既 剂 姬
氛	分 认 份 飞 粉 凡 奋 纷 泛 笨 纹 愤 芬 逢 匪
栏	范 担 络 兰 蓝 览 烂 懒 篮 滥 衍 攒 拦 澜 罕
狠	很 份 婚 根 呵 恨 痕 肾 浑 嗨 昏 韧 鹤 壬 贞
夹	家 加 价 假 角 佳 架 驾 甲 嘉 嫁 贾 迦 钾 戛
慈	次 此 词 急 笔 益 依 礼 击 材 刺 辞 磁 瓷 赐
爹	跌 邪 谐 裂 蟹 携 皆 猎 泄 蒂 蝎 劣 歇 劫 卸
脉	默 魔 末 摩 莫 磨 摸 膜 墨 陌 寞 抹 漠 沫 麽
厨	出 处 初 除 楚 础 触 储 撤 蔬 丶 橱 雏 锄 捶
邻	留 李 林 尽 临 琳 淋 赁 菱 榴 吟 彬 沦 殷 麟
脏	总 放 阳 往 藏 抗 羊 茫 踪 杠 胀 旸 葬 肪 镑
艳	验 严 颜 炎 燕 盐 沿 岩 掩 宴 咽 衍 腌 堰 焉
翔	想 相 像 向 象 项 响 香 享 良 乡 箱 详 祥 咁
遥	要 约 药 摇 邀 腰 妖 耀 咬 谣 岆 瑶 姚 钥 掏
仇	求 球 休 秋 齐 纠 驱 溜 丘 玖 祈 崎 邱 囚 妾
恼	保 哪 报 脑 闹 泡 腰 蹈 牢 躁 壕 窑 挠 糙 绸
寸	员 存 村 询 讯 轮 损 俊 挫 菌 韵 粹 蚕 峻 芸
串	换 穿 川 船 患 窗 缓 缠 唇 阐 馋 喘 醇 忏 篡
旋	选 宣 悬 暅 炫 玄 轩 萱 喧 渲 绚 璇 嬛 眩 漩
艰	见 简 检 坚 健 减 荐 键 践 鉴 尖 肩 舰 奸 牋
袭	西 喜 习 吸 悉 媳 晰 稀 溪 夕 兮 茜 曦 犀 烯
贯	关 管 观 官 馆 惯 冠 钻 灌 莞 罐 棺 纶 竿 眷
贡	工 公 功 共 供 控 攻 宗 宫 恭 讼 咏 巩 弓 咚
尿	教 条 挑 缴 漂 鸟 胶 矫 嚣 渺 碾 婊 廖 刁 侥
壮	长 专 装 张 状 涨 皇 庄 妆 撞 荒 凰 谎 慌 胀
燕	验 严 颜 炎 艳 盐 沿 岩 掩 宴 咽 衍 腌 堰 焉
荒	黄 床 皇 凰 谎 慌 霜 煌 晃 恍 焕 旷 惶 簧 潢
邓	当 等 登 灯 仍 碰 崩 彭 橙 澄 蹭 盯 耿 懵 凳
涂	图 足 句 土 突 途 宿 屋 欲 促 吐 徒 兔 叙 愈
剥	保 报 包 宝 告 抱 爆 暴 薄 饱 堡 胞 曝 萄 钥
卓	或 照 祝 昨 著 赵 桌 捉 佐 拙 灼 浊 酌 镯 锥
祥	想 相 像 向 象 项 响 香 享 乡 箱 详 献 翔 湘
涡	我 握 默 魔 卧 窝 沃 陌 脉 伍 噢 玻 喔 泼 倭
呈	成 程 城 充 声 承 诚 盛 乘 衡 撑 肠 秤 惩 甸
玲	零 领 兴 另 灵 令 龄 凌 铃 陵 岭 菱 聆 伶 拎
肚	都 度 读 独 顾 毒 督 杜 赌 渡 堵 妒 嘟 睹 镀
洪	东 红 终 综 荣 宏 虹 鸿 轰 笼 佣 哄 弘 雍 烘
乔	跳 巧 桥 敲 喵 悄 瞧 雀 侨 翘 俏 窍 缪 狡 撬
伍	五 物 午 武 舞 悟 乌 呜 勿 吾 巫 唔 坞 梧 捂
宅	海 找 孩 值 择 债 炸 晒 芝 摘 寨 咳 肢 窄 肇
盐	验 严 颜 炎 艳 燕 沿 岩 掩 宴 咽 衍 腌 堰 焉
扒	妈 达 马 怕 跑 牙 鸭 叭 爬 啪 葩 帕 趴 锕 耙
抛	跑 奥 泡 胖 邀 逃 遭 稿 扰 炮 啪 膏 稻 苞 袍
扑	普 武 夫 举 土 铺 谱 浦 葡 逾 醋 吾 菩 埔 仆
憾	汉 韩 含 寒 涵 喊 汗 函 扇 撼 旱 晗 焊 翰 罕
饿	哦 额 恶 俄 呃 鹅 噩 厄 鄂 遏 娥 讹 扼 胺 峨
栽	在 再 质 改 值 字 载 杂 拜 纸 灾 迫 遭 宰 哉
莉	力 利 礼 例 厘 隶 栗 哩 荔 篱 鲤 俐 珞 戾 砾
晕	员 论 运 云 孕 允 韵 蕴 匀 芸 酝 耘 峪 陨 昀
渴	可 科 客 课 则 克 刻 颗 壳 柯 磕 棵 苛 坷 珂
腻	你 尼 忆 拟 泥 逆 妮 埃 伱 倪 霓 匿 昵 幂 溺
滋	自 子 资 字 咨 仔 紫 姿 兹 籽 淄 梓 疵 呲 渍
贪	谈 慢 弹 探 坛 坦 摊 叹 碳 滩 炭 烫 谭 潭 毯
贤	现 限 县 鲜 献 闲 仙 陷 嫌 羡 咁 宪 咸 掀 衔
蟹	些 解 谢 协 鞋 械 邪 谐 携 泄 蝎 歇 卸 胁 斜
肋	了 乐 何 歌 德 各 河 刻 夜 旅 叻 撸 吕 搁 鹤
绕	导 告 澳 盗 邀 逃 遭 稿 扰 腰 矛 饶 郝 祷 苞
劝	全 权 券 幻 缘 圆 潜 迁 患 泉 拳 悬 谦 锻 犬
垫	点 电 店 便 典 潜 谦 颠 淀 殿 扂 巅 碘 奠 掂
渡	都 度 读 独 顾 舞 毒 督 杜 赌 肚 堵 妒 嘟 睹
晰	西 喜 习 吸 悉 媳 稀 溪 兮 茜 曦 犀 烯 嬉 羲
据	车 具 剧 局 句 居 举 巨 聚 距 拒 俱 拘 矩 菊
挡	当 党 档 唐 荡 昂 妨 纺 庞 橙 痒 瞪 壤 莽 裆
框	光 广 款 况 黄 康 狂 宽 矿 凰 谎 煌 旷 惶 匡
竹	主 助 祝 筑 猪 逐 珠 驻 柱 煮 丶 烛 株 嘱 铸
叹	谈 慢 弹 探 坛 坦 摊 贪 碳 滩 炭 烫 谭 潭 毯
鸣	明 名 影 民 请 并 形 命 灵 睛 铃 陵 铭 孟 芒
胞	保 报 包 宝 告 抱 爆 暴 薄 耗 浩 饱 堡 剥 曝
眠	面 见 联 线 免 健 潜 敏 兼 践 棉 淀 箭 绵 勉
循	婚 训 询 寻 讯 迅 遵 巡 逊 旬 勋 熏 驯 薰 浚
瞎	下 谢 夏 席 侠 霞 虾 辖 锡 弦 峡 狭 暇 瑕 匣
奉	更 风 丰 封 峰 疯 凤 锋 缝 蜂 冯 逢 讽 枫 绷
鹿	路 录 陆 绿 鲁 卢 碌 撸 芦 璐 卤 庐 禄 噜 泸
诱	有 友 又 油 右 邮 尤 幼 忧 幽 悠 犹 呦 佑 酉
肩	见 简 检 坚 健 减 荐 键 践 鉴 尖 舰 奸 捡 牋
蛇	师 设 社 始 属 核 啥 摄 舍 射 涉 遮 奢 舌 薯
歉	钱 千 签 潜 迁 欠 牵 谦 遣 铅 倩 嵌 谴 黔 钳
郎	王 浪 朗 辆 亡 荡 览 烂 懒 狼 廊 澜 菱 嗓 琅
拳	全 权 券 缘 圆 酸 潜 迁 患 泉 劝 悬 谦 锻 犬
壳	可 科 客 课 则 克 刻 颗 渴 柯 磕 棵 苛 坷 珂
侣	路 立 律 率 旅 虑 厉 垃 履 卢 撸 吕 滤 驴 铝
碧	比 必 毕 笔 币 逼 避 闭 彼 壁 鄙 弊 辟 臂 屄
熬	博 早 案 造 奥 澳 傲 凹 漠 瑶 敖 嗷 袄 艹 蘑
滨	音 近 边 版 避 欣 宾 碧 饼 辨 谨 斌 彬 尹 昕
莲	联 连 千 简 练 恋 脸 链 炼 怜 廉 谦 舰 帘 敛
喂	位 微 味 卫 谓 慰 伪 胃 薇 韦 畏 惟 猥 萎 玮
臭	后 受 售 抽 授 丑 筹 兽 瘦 酬 愁 舟 吼 骤 轴
伏	服 付 父 富 府 附 妇 幅 肤 辅 傅 抚 弗 辐 缚
稀	西 喜 习 吸 悉 媳 晰 溪 夕 兮 茜 曦 犀 烯 嬉
覆	付 父 富 附 妇 符 幅 傅 伏 抚 腹 弗 辐 缚 俯
沿	验 严 颜 炎 艳 燕 盐 岩 掩 宴 咽 衍 腌 堰 焉
函	汉 韩 含 寒 涵 喊 汗 憾 撼 旱 晗 焊 翰 罕 悍
枝	之 只 直 制 质 智 织 纸 址 芝 旨 滞 蜘 酯 炙
兑	对 规 队 递 堆 杜 恢 赌 催 怼 诡 剁 髓 匮 璀
癌	爱 细 哎 艾 亦 唉 碍 埃 欸 挨 哀 凹 矮 暧 逮
振	真 镇 针 珍 圳 震 阵 诊 侦 贞 甄 枕 帧 疹 臻
昆	论 运 困 均 寻 允 夸 晕 坤 屯 捆 汛 昀 鲲 珺
勾	友 候 又 够 购 构 狗 沟 谷 雇 钩 苟 逅 垢 鸥
饼	并 病 冰 兵 迎 屏 蚌 丙 斌 秉 彬 柄 甭 泾 炳
肠	场 常 唱 章 厂 赏 偿 昌 尝 畅 撑 倡 惩 敞 樟
赫	和 合 何 呵 河 核 喝 呼 叶 隔 哲 盒 荷 吓 贺
噢	哦 阿 波 哟 拨 沃 俄 喔 寞 驳 倭 噩 厄 渤 鄂
纵	从 总 统 融 综 荣 宗 宋 踪 衷 桐 怂 棕 憎 粽
赠	总 政 风 梦 增 曾 仍 盟 疼 蒙 郑 疯 逢 彭 耕
愤	分 认 份 飞 粉 凡 奋 纷 泛 笨 纹 氛 芬 逢 匪
瞬	身 数 水 书 税 申 睡 顺 慎 蠢 浑 衫 墅 蜀 汕
辰	称 陈 审 甚 纯 沉 晨 尘 诊 臣 趁 衬 秤 甄 逞
虹	功 红 终 综 荣 宏 洪 鸿 轰 笼 佣 哄 弘 烘 拢
玻	博 爸 播 笔 波 佛 伯 拨 勃 鄙 搏 泊 驳 脖 渤
咬	要 约 药 摇 邀 腰 妖 耀 遥 谣 岆 瑶 姚 钥 茅
携	些 解 谢 写 协 鞋 械 邪 谐 蟹 泄 蝎 歇 卸 胁
溪	西 喜 习 吸 悉 媳 晰 稀 夕 兮 茜 曦 犀 烯 嬉
乙	意 艺 疑 译 遗 姨 疫 毅 椅 绎 夷 沂 壹 倚 咦
朴	销 票 跳 偏 漂 尿 娇 吊 飘 嫖 刁 僚 逍 叼 绞
耍	化 啥 述 杀 输 刷 舒 硕 滑 厦 暑 莎 衰 疏 抒
羽	于 预 遇 域 余 雨 宇 愉 郁 愚 寓 裕 逾 瑜 舆
廉	联 连 简 练 恋 脸 链 炼 怜 莲 辽 羡 帘 敛 斓
酬	后 受 售 抽 授 丑 筹 兽 瘦 臭 愁 舟 吼 骤 轴
抑	意 艺 疑 译 遗 姨 疫 毅 椅 绎 夷 沂 壹 倚 咦
跪	规 贵 归 鬼 柜 轨 毁 醉 瑰 桂 闺 龟 硅 崔 诡
芝	之 只 直 制 质 智 织 纸 址 枝 旨 滞 蜘 酯 炙
辨	变 边 编 减 荐 键 遍 辩 贬 纤 弦 煎 捡 咸 鞭
啡	费 非 飞 贝 肥 菲 废 眉 肺 妃 匪 沸 绯 翡 斐
娇	交 校 较 叫 角 缴 胶 骄 椒 矫 搅 蕉 浇 轿 嚼
伸	身 设 神 深 申 审 甚 沈 慎 痕 肾 渗 绅 婶 甥
吊	校 较 掉 脚 刀 蹈 尿 屌 雕 敲 喵 悄 钓 撩 飙
谨	进 金 今 近 极 尽 仅 紧 津 禁 劲 斤 锦 晋 巾
涯	亚 呀 压 雅 牙 押 鸭 洒 丫 吖 芽 讶 哑 鸦 崖
哆	多 读 货 队 夺 朵 躲 萝 堕 裹 稻 捣 剁 惰 舵
孝	小 笑 消 销 效 晓 屌 肖 萧 削 宵 潇 嚣 霄 硝
旺	网 望 玩 帮 王 往 忘 唐 亡 旁 汤 仿 荡 汪 妄
恭	工 公 功 共 供 控 攻 宗 宫 贡 讼 咏 巩 弓 咚
愁	后 受 售 抽 授 丑 筹 兽 瘦 臭 酬 舟 吼 骤 轴
戚	七 汽 妻 旗 骑 棋 歧 琪 岂 祈 乞 琦 凄 绮 砌
颖	应 影 英 营 硬 映 赢 盈 婴 鹰 樱 莹 荧 蝇 萤
俱	车 局 句 举 巨 距 惧 矩 菊 焗 橘 狙 鞠 驹 沮
吻	文 问 微 温 粉 闻 稳 纷 纹 畏 挽 丸 雯 蚊 潍
凑	处 走 油 构 某 斗 欧 础 肉 丑 忧 储 犹 粗 猴
臣	称 陈 审 甚 纯 沉 晨 尘 诊 辰 趁 衬 秤 甄 醇
杆	感 万 干 敢 赶 残 甘 盐 憾 肝 尴 赣 棺 樊 竿
怖	不 部 步 补 布 苦 爸 播 负 捕 卜 埠 簿 哺 渤
浦	普 武 土 铺 谱 扑 葡 凸 醋 啤 妒 吾 菩 埔 仆
遮	这 着 者 至 折 喆 哲 浙 竹 蛇 枝 振 赫 辙 烛
瑰	该 规 贵 归 鬼 柜 轨 毁 醉 跪 桂 闺 龟 硅 卦
坊	方 放 房 帮 阳 防 堂 封 访 扬 汤 仿 番 昂 狼
堪	看 男 难 万 烦 颜 咱 刊 惨 摊 栏 艳 砍 坎 侃
惧	车 具 局 句 举 距 俱 矩 菊 焗 橘 狙 鞠 驹 沮
梯	体 题 提 益 替 徒 剂 踢 剔 漓 畸 惕 蹄 涕 剃
茫	命 养 阳 往 梦 党 忙 脏 挡 鸣 郎 盲 杠 囊 塘
遵	足 军 座 询 坐 轮 尊 俊 醉 阻 循 敦 琢 勋 峻
埋	满 谈 范 慢 漫 贸 蛮 曼 肝 滥 婉 谭 衍 瞒 蔓
妥	索 托 脱 锁 拖 拓 桃 陶 魄 屠 陀 驼 唾 糯 灬
谅	两 量 讲 亮 练 奖 良 令 辆 梁 凉 粮 靓 帘 晾
脆	队 退 瑞 吹 腿 催 粹 翠 崔 怼 贿 摧 萃 荟 捶
冻	动 东 懂 登 顶 灯 勇 冬 宗 洞 聪 董 纵 筒 栋
裸	活 或 落 罗 洛 逻 啰 萝 螺 囖 撸 卤 烙 骆 锣
牢	老 包 络 劳 毫 栏 恼 剥 捞 膏 稻 螺 姥 佬 唠
渣	直 查 插 咋 扎 炸 诈 柱 挚 闸 榨 眨 乍 诧 炙
胃	位 微 味 卫 谓 慰 伪 薇 魏 韦 畏 惟 猥 萎 玮
俺	安 完 班 干 演 案 按 兰 暗 胆 甘 岸 氨 鞍 揽
贺	和 合 何 呵 河 核 喝 呼 盒 荷 吓 赫 禾 搁 鹤
晋	进 金 今 近 尽 仅 紧 洁 津 禁 劲 斤 锦 肩 谨
纱	使 失 识 啥 杀 沙 傻 厦 晒 莎 屎 扇 疏 洒 砂
赋	服 复 付 父 富 附 符 幅 傅 伏 抚 腹 弗 辐 缚
疆	将 讲 江 奖 降 乡 镜 净 渐 辆 谅 姜 酱 囧 蒋
赤	吃 持 础 迟 池 尺 痴 驰 齿 耻 斥 侈 翅 祠 炽
慎	身 设 神 深 申 审 甚 剩 沈 伸 肾 渗 绅 婶 甥
凹	案 造 奥 泡 澳 傲 熬 漠 瑶 敖 嗷 袄 艹 藻 懊
皆	接 结 节 姐 介 街 借 阶 杰 洁 截 揭 劫 羯 桔
弯	完 万 玩 晚 饭 湾 碗 挽 塆 灿 丸 婉 谭 顽 腕
飘	销 票 跳 偏 漂 尿 朴 娇 吊 嫖 廖 刁 僚 逍 瞄
涛	包 套 讨 淘 泰 逃 妖 桃 陶 萄 掏 茂 昊 噪 韬
猴	后 候 收 又 否 扣 偶 搜 透 厚 抖 侯 吼 喉 搂
迈	买 太 百 再 该 改 卖 态 害 灾 麦 栽 乃 霉 狸
烤	考 早 造 靠 淘 骚 阔 躁 澡 砍 坎 岆 瑶 拷 曜
撕	四 司 思 死 斯 食 素 似 丝 私 寺 肆 饲 嘶 厮
蔡	才 带 吃 白 此 持 财 彩 材 采 菜 哎 裁 猜 埃
苗	表 教 笑 疗 描 貌 妙 秒 胶 帽 辽 骄 喵 庙 渺
愚	于 预 遇 域 余 雨 宇 愉 郁 寓 豫 裕 逾 瑜 舆
脂	之 知 只 直 制 质 智 织 纸 址 枝 旨 滞 蜘 酯
崩	更 丰 恒 坑 蚌 蹦 泵 枫 翁 藤 蓬 懵 膨 绷 甭
棋	气 企 启 妻 旗 骑 歧 琪 祈 祁 砌 麒 迄 柒 岐
铜	同 通 统 痛 童 隆 筒 桶 桐 彤 瞳 粽 捅 悚 倘
桂	该 规 贵 归 鬼 柜 轨 毁 跪 瑰 闺 龟 硅 卦 崔
糟	保 再 早 造 搞 倒 岛 盗 遭 槽 抛 牢 躁 澡 兆
柳	六 流 留 刘 露 励 漏 裂 浏 梨 溜 瘤 榴 硫 琉
汪	网 让 望 玩 帮 王 往 忘 亡 旁 汤 仿 荡 旺 妄
悬	选 宣 旋 暅 炫 玄 轩 萱 喧 渲 绚 璇 嬛 眩 漩
砖	专 转 传 战 环 赚 占 抓 幻 船 妆 患 撞 粘 撰
哒	大 打 单 带 达 答 怕 搭 抵 塔 涯 疤 坝 嗒 喀
铃	零 领 另 灵 令 龄 凌 玲 陵 岭 盯 菱 聆 伶 拎
兜	独 构 斗 欧 肉 豆 偷 忧 幽 犹 逗 抖 痘 钩 陡
乖	该 管 观 规 贵 块 概 怀 坏 怪 盖 轨 跪 闺 灌
谦	前 千 签 潜 迁 欠 牵 遣 铅 乾 倩 嵌 谴 黔 钳
陵	零 领 另 灵 令 龄 井 凌 玲 铃 岭 菱 聆 伶 拎
锻	观 店 远 段 断 短 端 援 旋 贯 劝 垫 拳 缎 璇
岩	验 严 颜 炎 艳 燕 盐 掩 宴 咽 衍 腌 堰 焉 谚
帽	包 毛 猫 闹 贸 貌 冒 矛 浩 茅 冇 茂 昊 噪 韬
蓄	需 许 续 须 序 虚 绪 徐 叙 旭 畜 絮 恤 婿 墟
碗	完 万 玩 晚 饭 湾 弯 挽 塆 丸 婉 谭 雯 顽 腕
苍	让 场 从 藏 仓 荡 邦 挡 郎 灿 趟 芒 沧 蚕 舱
舰	见 简 检 坚 健 监 减 荐 践 鉴 尖 肩 奸 煎 牋
曹	超 早 造 参 操 草 遭 稿 吵 扰 耗 腰 矛 萄 钥
猛	明 梦 增 盟 蒙 萌 恒 赠 捧 扔 孟 懵 愣 亨 檬
脾	批 皮 屁 疲 匹 披 啤 劈 癖 痞 坯 霹 琵 媲 丕
仲	中 种 重 证 政 终 众 钟 症 忠 帐 宠 肿 衷 蒸
抚	服 复 付 父 富 府 附 符 幅 傅 伏 腹 弗 辐 缚
瓦	妈 它 达 马 吴 娃 挖 哇 鸭 叭 雾 爬 喔 袜 蛙
馨	行 性 请 星 形 型 评 兴 幸 灵 醒 硬 箱 竞 姓
丧	商 放 房 洋 钢 仰 昂 芳 脏 桑 庞 痒 沧 烫 颂
曝	保 报 包 宝 导 抱 爆 暴 薄 耗 饱 堡 剥 胞 茅
辽	交 料 聊 疗 漂 牢 飘 苗 撩 寥 廖 僚 逍 烙 叼
奢	师 设 社 属 核 啥 摄 舍 射 涉 蛇 遮 舌 抒 薯
巡	婚 军 训 询 寻 讯 迅 循 遵 逊 旬 勋 熏 钝 驯
猎	留 列 烈 裂 劣 咧 膊 戾 偕 秸 丿 镍 遴 砾 乜
宰	在 再 质 改 值 字 载 杂 拜 纸 灾 迫 栽 哉 躁
羡	现 先 限 县 鲜 献 闲 仙 陷 嫌 宪 咸 掀 衔 腺
契	七 汽 启 妻 骑 棋 歧 琪 岂 祈 乞 琦 凄 绮 砌
哉	在 再 质 改 值 字 载 杂 拜 纸 灾 迫 栽 宰 躁
盲	命 养 阳 往 梦 党 忙 脏 挡 鸣 郎 茫 杠 囊 塘
姜	相 两 将 讲 江 奖 监 竟 降 剑 兼 疆 酱 蒋 僵
署	书 术 熟 述 树 舒 叔 殊 暑 疏 蔬 抒 赎 薯 墅
夕	西 喜 习 吸 悉 媳 晰 稀 溪 兮 茜 曦 犀 烯 嬉
庸	用 永 拥 勇 纵 虹 泳 涌 笼 佣 溶 咏 雍 嵩 甬
戈	个 格 歌 各 哥 革 隔 耶 割 葛 鸽 阁 搁 嘎 褐
颠	点 电 店 便 典 潜 垫 谦 锻 淀 殿 扂 巅 碘 奠
痴	吃 此 持 迟 池 尺 赤 驰 齿 耻 斥 侈 翅 睬 酯
霞	下 谢 夏 侠 瞎 虾 辖 锡 峡 狭 暇 瑕 匣 钾 遐
霍	活 或 货 火 获 伙 悔 扩 惑 裸 祸 裹 豁 昊 壕
闺	规 贵 估 归 鬼 柜 轨 毁 跪 瑰 桂 龟 硅 卦 崔
咁	现 先 限 县 鲜 献 闲 仙 陷 嫌 羡 宪 咸 掀 衔
鸭	它 亚 呀 压 雅 牙 罚 押 涯 丫 吖 芽 讶 哑 幺
捐	检 坚 官 监 端 减 圈 卷 劵 倦 娟 眷 柬 嬛 辕
肿	中 种 重 证 政 终 众 钟 郑 症 忠 帐 宠 仲 衷
狱	于 预 遇 域 余 雨 宇 愉 郁 愚 寓 豫 逾 瑜 舆
乃	能 百 拿 概 采 奶 贷 派 拜 耐 娜 裁 凯 猜 奈
叭	吧 八 把 报 哈 拿 爸 巴 避 娃 拔 芭 罢 疤 搏
谊	意 艺 疑 译 遗 姨 疫 毅 椅 绎 夷 裔 沂 壹 倚
泄	些 解 谢 写 协 鞋 械 邪 谐 蟹 携 蝎 歇 卸 胁
腹	服 复 付 父 富 府 附 符 幅 傅 伏 抚 弗 辐 缚
婴	影 英 营 硬 映 赢 盈 颖 鹰 樱 莹 荧 蝇 萤 莺
骄	交 校 较 叫 角 缴 焦 胶 娇 椒 矫 搅 蕉 浇 轿
雾	五 无 物 午 武 舞 悟 乌 伍 呜 勿 吾 巫 唔 坞
啰	活 或 落 罗 洛 逻 裸 萝 螺 囖 撸 噜 骆 锣 颅
肃	诉 速 素 舞 鱼 苏 宿 俗 塑 吾 舆 巫 辜 唔 尉
厘	理 利 立 离 礼 例 丽 励 黎 栗 吏 俐 俪 珞 笠
莎	使 失 识 啥 杀 沙 傻 厦 纱 屎 扇 疏 洒 砂 刹
蒂	地 第 低 底 弟 递 帝 滴 迪 抵 敌 堤 笛 旳 缔
爬	它 达 马 怕 跑 牙 扒 鸭 叭 啪 葩 帕 趴 蒲 噗
喔	我 握 佛 魔 卧 窝 膜 哟 沃 脉 涡 伍 熬 泼 倭
叙	需 许 续 须 序 虚 绪 徐 蓄 旭 畜 絮 恤 婿 墟
躲	多 读 货 队 夺 朵 哆 萝 堕 裹 稻 捣 剁 惰 舵
屌	校 掉 娇 吊 孝 飘 雕 椒 悄 钓 撩 飙 饺 婊 廖
愈	于 预 遇 域 余 雨 宇 愉 郁 愚 寓 豫 逾 瑜 舆
惹	色 客 热 哥 隔 韧 鹤 壬 涩 刃 椰 磕 冶 棵 噩
衰	说 水 税 睡 怀 坏 刷 帅 晒 耍 摔 甩 淮 筛 揣
纲	房 刚 港 访 央 棒 钢 攻 岗 杭 仰 杠 纺 庞 痒
岳	月 语 越 余 阅 玉 悦 跃 晕 豫 喻 韵 浴 掘 玥
蝎	些 解 谢 写 协 鞋 械 邪 谐 蟹 携 泄 歇 卸 胁
奸	见 简 检 坚 健 监 减 荐 践 鉴 尖 肩 舰 煎 牋
卜	不 部 步 补 布 苦 播 负 捕 污 谱 怖 埠 簿 哺
葛	个 格 歌 各 哥 革 隔 割 戈 鸽 阁 搁 菇 褐 噩
瓷	次 此 词 急 笔 益 依 礼 击 材 刺 辞 圾 磁 慈
炉	录 陆 绿 鲁 鹿 卢 碌 璐 卤 庐 禄 噜 泸 虏 麓
劣	留 列 烈 裂 猎 咧 膊 戾 偕 秸 丿 镍 遴 砾 乜
摘	至 指 站 择 追 址 占 债 植 拆 宅 寨 兆 罩 昭
纽	究 您 修 努 牛 逆 怒 柳 扭 浏 妞 绣 捏 瘤 玖
寞	模 默 魔 末 摩 莫 磨 摸 膜 墨 陌 脉 抹 漠 沫
桑	商 放 房 洋 钢 仰 昂 芳 脏 丧 庞 痒 沧 妄 颂
逸	意 艺 疑 译 遗 姨 疫 毅 椅 绎 夷 裔 沂 壹 倚
驻	主 助 祝 筑 猪 逐 竹 煮 丶 株 嘱 铸 诛 蛛 瞩
屎	十 事 什 市 失 识 士 适 石 势 室 释 饰 尸 拾
堵	都 度 读 独 顾 毒 督 杜 赌 肚 渡 瑜 妒 嘟 睹
谣	要 约 药 摇 邀 腰 妖 桃 耀 遥 咬 岆 瑶 姚 钥
寓	于 预 遇 域 余 雨 宇 愉 郁 愚 豫 裕 逾 瑜 舆
塌	他 她 图 它 达 塔 踏 瓦 鸭 叭 爬 祂 惕 咔 粑
痕	很 份 婚 根 呵 恨 狠 浑 嗨 昏 韧 鹤 壬 贞 刃
忌	己 机 集 击 激 吉 辑 既 寂 稽 饥 姬 嫉 脊 妓
泳	用 永 拥 勇 冬 宗 盈 庸 涌 佣 咏 雍 侬 甬 踊
挫	活 错 获 措 惑 夺 哆 翠 豁 醋 嗦 搓 蓑 璀 磋
璃	里 利 立 礼 例 丽 励 厘 栗 沥 荔 俐 俪 珞 戾
柯	可 科 客 课 克 刻 颗 渴 壳 磕 棵 恳 苛 坷 珂
祸	活 或 货 火 获 伙 魂 扩 桌 惑 霍 豁 昊 剁 壕
酱	量 将 讲 江 警 奖 竟 良 静 降 剑 兼 鉴 疆 姜
暅	选 宣 旋 悬 炫 玄 轩 萱 喧 渲 绚 璇 嬛 眩 漩
骚	号 包 刀 散 淘 盗 邀 扫 曝 稻 嫂 冇 嚎 叁 羔
雕	校 掉 娇 吊 孝 飘 屌 椒 悄 钓 撩 飙 饺 婊 廖
狐	户 护 互 乎 湖 胡 虎 忽 糊 沪 壶 蝴 葫 弧 唬
扇	山 善 删 闪 汗 陕 擅 衫 珊 杉 汕 姗 煽 讪 膳
叉	处 持 差 察 茶 插 傻 潮 储 咋 迟 耻 澈 岔 茬
逝	十 事 什 实 试 失 识 士 适 石 势 室 释 狮 尸
阔	括 库 弱 扩 措 惑 夺 愧 螺 撮 搓 惰 捆 窥 骆
抹	模 默 魔 末 摩 莫 磨 摸 墨 陌 脉 寞 漠 沫 麽
凰	欢 换 黄 床 皇 壮 荒 唤 谎 慌 煌 晃 恍 疮 惶
唤	欢 换 环 幻 患 寒 缓 涵 喊 焕 桓 痪 寰 浣 宦
唻	来 海 利 孩 带 奶 累 兰 灾 泪 勒 赖 莱 嘞 掰
肖	小 笑 消 销 效 晓 孝 辽 萧 削 宵 潇 嚣 霄 硝
扭	究 您 修 努 牛 逆 怒 柳 纽 浏 妞 绣 捏 瘤 玖
牧	目 母 努 府 密 舞 木 幕 慕 姆 墓 募 瑜 谜 穆
诈	直 查 插 咋 扎 炸 渣 柱 挚 闸 榨 眨 乍 诧 炙
辱	如 入 故 诉 付 孤 宇 虎 予 乳 蓄 狱 腹 雾 肃
薇	位 微 味 卫 威 谓 慰 伪 胃 韦 畏 惟 猥 萎 玮
叻	了 乐 何 歌 德 各 河 刻 夜 旅 肋 撸 吕 搁 鹤
湘	想 相 像 向 象 项 响 香 享 乡 箱 详 翔 祥 厢
肝	感 万 干 敢 赶 残 甘 艳 燕 盐 憾 杆 尴 赣 棺
驰	吃 此 持 迟 池 尺 赤 痴 齿 耻 斥 侈 翅 睬 酯
琳	李 林 尽 临 邻 淋 赁 菱 榴 吟 彬 沦 麟 霖 吝
浏	六 流 留 牛 刘 柳 溜 芦 瘤 咧 韭 榴 陋 硫 庐
萧	小 笑 消 销 效 晓 孝 辽 肖 削 宵 潇 嚣 霄 硝
踪	总 松 综 宗 纵 赠 恭 冻 铜 仲 诵 绒 弘 溶 拢
矮	爱 细 哎 艾 亦 唉 碍 埃 欸 挨 哀 癌 凹 暧 漓
虐	女 呢 略 薛 倪 鹅 爵 瑟 霓 禾 碟 叠 吕 捏 疟
淫	因 音 义 医 银 引 印 阴 隐 饮 姻 瘾 吟 殷 尹
齿	吃 此 持 迟 池 尺 赤 痴 驰 耻 斥 侈 翅 睬 酯
贱	见 简 检 坚 健 监 减 践 鉴 尖 肩 舰 奸 煎 牋
梨	里 利 立 礼 例 丽 励 厘 栗 沥 荔 俐 俪 珞 戾
豫	于 预 遇 域 余 雨 宇 愉 郁 愚 寓 裕 逾 瑜 舆
敦	但 讯 润 顿 君 迅 盾 遵 巡 耽 吨 妒 蹲 囤 炖
踢	体 题 提 益 击 替 梯 剔 狄 惕 蹄 涕 剃 嚏 啼
谎	欢 黄 皇 壮 荒 凰 唤 慌 煌 晃 恍 焕 疮 惶 簧
躁	保 早 造 搞 倒 岛 盗 逃 遭 槽 抛 牢 糟 澡 兆
澡	保 早 造 搞 倒 岛 盗 逃 遭 槽 抛 牢 糟 躁 兆
疫	意 艺 疑 译 遗 姨 毅 椅 绎 夷 沂 壹 倚 咦 轶
抖	独 构 斗 欧 肉 豆 偷 忧 幽 犹 逗 兜 痘 钩 陡
棉	面 见 联 线 免 健 潜 敏 兼 践 眠 淀 箭 绵 勉
衷	中 种 重 证 政 终 众 钟 掌 症 忠 帐 宠 仲 肿
毅	意 艺 疑 译 遗 姨 疫 椅 绎 夷 沂 壹 倚 咦 轶
拘	车 局 句 举 距 俱 惧 矩 菊 焗 橘 狙 鞠 驹 沮
囧	将 京 竞 穷 径 晶 井 酱 凶 浆 颈 荆 琼 璟 汹
抬	太 台 态 败 哎 泰 胎 桃 哀 癌 汰 亥 毯 暧 逮
氧	样 养 阳 杨 央 洋 扬 羊 仰 旸 痒 烊 秧 漾 谤
虾	下 谢 佳 夏 侠 瞎 霞 辖 锡 弦 宵 胁 峡 狭 暇
尬	哪 该 格 它 干 达 巴 孤 扒 爬 葛 疤 膏 噶 嘎
馈	快 腿 亏 愧 溃 葵 窥 盔 魁 奎 匮 悴 睢 傀 睽
巾	进 金 今 近 尽 坚 仅 紧 津 禁 劲 斤 锦 滨 谨
柱	主 助 祝 筑 猪 逐 竹 驻 煮 丶 株 嘱 铸 诛 蛛
贬	变 片 边 编 减 荐 键 遍 辩 辨 纤 煎 捡 鞭 黔
喻	于 预 遇 域 余 雨 宇 愉 郁 愚 寓 裕 逾 瑜 舆
菌	军 均 伦 混 君 俊 允 锦 逊 裙 骏 峻 芸 抉 捆
歇	些 解 谢 写 协 鞋 械 邪 谐 携 泄 蝎 卸 胁 斜
韵	员 运 云 孕 允 晕 蕴 匀 芸 酝 耘 陨 昀 熨 筠
芬	分 认 门 份 飞 粉 凡 奋 纷 笨 纹 氛 愤 逢 匪
弥	米 依 礼 密 迷 秘 蜜 咪 谜 幂 泌 靡 牡 觅 眯
灌	关 管 观 官 馆 惯 冠 钻 逛 援 贯 莞 罐 棺 纶
粹	队 退 瑞 吹 腿 磁 催 脆 翠 崔 怼 贿 摧 萃 荟
呐	那 哪 拿 码 亚 怕 纳 罚 娜 涯 哒 啪 匿 噶 趴
寺	四 司 思 死 斯 食 击 似 丝 私 撕 肆 饲 嘶 厮
缠	产 纯 昌 灿 阐 禅 焊 馋 蝉 掺 铲 盏 崭 忏 搀
熙	西 喜 息 吸 惜 悉 媳 晰 夕 锡 兮 茜 隙 玺 烯
歧	气 企 器 启 妻 旗 骑 棋 琪 祈 乞 绮 砌 麒 迄
鸿	东 功 红 终 综 荣 宏 洪 虹 轰 笼 哄 弘 雍 烘
凝	星 精 英 亲 宁 鹰 钉 莹 盯 荆 萍 秉 冥 叮 靖
盆	品 任 闻 奋 奔 拼 赔 纷 喷 佩 氛 狠 愤 棚 粪
炫	选 宣 旋 悬 暅 玄 轩 萱 喧 渲 绚 璇 嬛 眩 漩
魏	位 微 味 卫 谓 慰 伪 胃 薇 韦 畏 惟 猥 萎 玮
劫	接 结 界 姐 介 街 借 阶 洁 截 揭 皆 羯 桔 诫
缝	等 风 嗡 粉 丰 封 峰 疼 蒙 疯 凤 锋 奉 蜂 冯
卸	些 解 谢 写 协 鞋 械 邪 谐 携 泄 蝎 歇 胁 斜
汁	之 直 制 质 支 职 智 执 止 织 纸 芝 旨 挚 酯
蜂	等 风 嗡 粉 丰 封 峰 疼 蒙 疯 凤 锋 奉 缝 冯
疏	书 术 属 述 树 舒 叔 殊 暑 鼠 署 梳 抒 赎 薯
锐	惠 退 若 灰 悔 瑞 徽 毁 桂 龟 睿 讳 葵 盔 蕊
凶	想 行 相 向 型 象 项 乡 箱 兄 雄 穷 熊 胸 馨
漠	模 默 魔 末 摩 莫 磨 摸 膜 墨 陌 脉 寞 抹 沫
粘	展 张 传 照 查 站 战 占 诊 丈 颤 詹 沾 斩 窄
煮	主 助 祝 筑 猪 逐 竹 驻 丶 株 嘱 铸 诛 蛛 瞩
逊	训 询 寻 讯 迅 循 巡 旬 勋 沦 熏 钝 绚 驯 薰
晴	情 请 清 亲 青 轻 庆 竞 倾 井 卿 擎 氢 拎 穹
砍	看 男 难 万 烦 颜 咱 刊 惨 摊 栏 艳 堪 坎 侃
裙	论 取 群 村 缺 困 孙 迅 俊 循 拳 敦 诠 屯 郡
芯	心 新 信 您 欣 辛 嘻 拼 薪 鑫 腺 吟 彬 膝 杏
洒	把 达 阿 斯 搭 咯 玛 踏 塞 撒 萨 葩 涩 喇 蛤
涌	用 永 拥 勇 虹 庸 泳 笼 佣 匆 咏 雍 嵩 甬 踊
贾	家 加 价 假 酒 佳 架 驾 甲 嘉 嫁 夹 迦 钾 戛
殖	之 直 制 质 支 职 智 执 止 织 纸 芝 旨 挚 酯
蒋	量 将 讲 江 警 奖 竟 良 静 降 剑 疆 姜 酱 僵
坎	看 男 凡 颜 咱 刊 惨 摊 堪 砍 侃 勘 衍 旱 晗
墓	目 母 努 府 密 木 幕 慕 姆 牧 募 瑜 谜 穆 畜
痘	独 构 斗 欧 肉 豆 偷 忧 幽 犹 逗 兜 抖 钩 陡
筋	进 金 今 音 近 尽 仅 紧 津 禁 劲 斤 锦 肩 谨
肺	费 非 份 飞 威 肥 菲 废 喂 啡 妃 匪 沸 绯 翡
葱	从 总 容 仓 聪 宋 孔 宠 隆 浓 匆 丛 瞳 咚 嵩
溜	六 流 留 刘 陆 励 漏 柳 浏 梨 瘤 榴 硫 琉 遛
腔	前 相 两 强 响 良 抢 枪 墙 湘 僵 琼 乾 卿 谴
尴	感 万 干 敢 赶 残 甘 盐 憾 杆 肝 镐 赣 棺 樊
趁	真 称 承 陈 沉 晨 彻 恨 撑 尘 振 辰 臣 侦 衬
岆	要 约 药 劳 摇 邀 腰 妖 耀 饱 遥 咬 谣 瑶 姚
疲	批 皮 屁 脾 匹 披 啤 劈 癖 痞 坯 霹 琵 媲 丕
霉	没 美 位 每 妹 媒 梅 赔 煤 魅 眉 玫 枚 昧 媚
削	小 笑 消 销 效 晓 胶 孝 咁 肖 萧 宵 潇 嚣 霄
呜	五 无 物 午 武 舞 悟 乌 伍 勿 吾 巫 唔 坞 梧
淀	点 电 边 店 便 连 典 兼 迁 垫 颠 贬 殿 扂 巅
颇	破 婆 默 魔 霸 坡 陌 脉 泼 蜗 趴 菩 珀 陂 坯
侯	后 候 收 又 头 受 否 售 扣 偶 厚 猴 吼 喉 疣
僵	量 将 讲 江 警 奖 竟 良 静 降 剑 疆 姜 酱 蒋
筒	同 通 统 痛 童 攻 隆 铜 桶 桐 彤 瞳 粽 捅 倘
膀	帮 榜 访 央 棒 洋 邦 绑 仰 苍 丧 纲 缸 柄 冈
陕	山 善 删 闪 厦 扇 擅 衫 旱 珊 杉 汕 姗 煽 讪
耻	直 吃 持 迟 池 尺 赤 痴 驰 齿 斥 侈 翅 炽 嗤
歪	外 万 台 玩 改 委 嘅 奶 呆 挖 塞 哇 抬 魏 佰
浴	于 预 遇 域 余 雨 宇 愉 郁 愚 寓 裕 逾 瑜 舆
铭	明 名 命 兵 迎 净 丁 鸣 殑 冥 璟 柠 檬 茗 泠
玄	选 宣 旋 悬 暅 炫 轩 萱 喧 渲 绚 璇 嬛 眩 漩
舅	就 九 究 句 即 酒 久 救 旧 纠 揪 浸 玖 韭 灸
辖	下 谢 吸 夏 席 侠 瞎 霞 虾 锡 弦 峡 狭 暇 瑕
捧	等 朋 嗡 蒙 碰 缝 蜂 鹏 彭 棚 翁 坪 藤 磅 蓬
鹏	等 朋 嗡 蒙 碰 缝 蜂 捧 彭 棚 翁 坪 藤 磅 蓬
掩	验 严 烟 颜 炎 艳 燕 盐 沿 岩 宴 咽 衍 腌 堰
粒	理 里 力 利 立 历 离 黎 莉 厘 璃 隶 栗 哩 沥
犬	全 权 券 幻 缘 圆 潜 迁 患 泉 劝 拳 悬 谦 锻
伐	发 法 亚 怕 饭 附 罚 乏 伏 覆 祂 阀 哑 靶 鸦
宙	主 手 周 首 州 洲 厚 兽 瘦 侯 舟 吼 骤 轴 咒
敲	巧 桥 乔 悄 瞧 雀 侨 翘 俏 窍 婊 虔 撬 跷 峭
瑶	要 约 药 劳 摇 邀 腰 妖 耀 饱 遥 咬 谣 岆 姚
役	意 艺 疑 译 遗 姨 疫 毅 椅 绎 夷 沂 壹 倚 咦
奴	付 足 句 努 屋 欲 促 距 幅 督 肤 怒 豫 拘 喻
鸽	个 格 歌 各 哥 革 隔 耶 割 戈 葛 阁 搁 嘎 褐
履	女 路 立 律 率 旅 虑 厉 垃 侣 卢 撸 吕 滤 驴
桶	同 通 统 永 痛 童 隆 铜 筒 桐 藤 彤 瞳 捅 倘
岭	零 领 轻 另 灵 令 龄 凌 玲 铃 陵 菱 聆 伶 拎
箭	见 简 检 坚 健 监 减 荐 践 鉴 尖 肩 舰 奸 牋
柴	产 才 超 差 材 采 察 朝 拆 抄 巢 馋 翅 翟 茬
漆	七 汽 妻 骑 棋 契 歧 岂 祈 乞 琦 凄 绮 砌 迄
冯	风 份 曾 登 丰 封 峰 疼 疯 凤 锋 奉 坊 缝 蜂
妨	方 放 房 养 阳 往 防 党 访 仿 番 昂 芳 脏 坊
憋	别 毕 笔 瘪 鳖 聂 膊 邂 痹 缤 陛 榭 殡 偕 秸
踩	才 带 吃 白 此 持 财 彩 材 采 菜 哎 裁 猜 埃
娶	去 区 取 句 曲 趣 距 幅 趋 驱 屈 渠 叙 愈 躯
劵	检 坚 官 健 软 监 端 圈 卷 捐 倦 娟 眷 柬 辕
绵	面 先 见 联 免 健 潜 敏 兼 迁 践 眠 棉 淀 勉
御	于 预 遇 域 余 雨 宇 愉 郁 愚 寓 裕 逾 瑜 舆
讼	红 共 送 供 融 松 宋 泳 轰 诵 颂 嵩 怂 耸 悚
躺	忘 痛 堂 钢 羊 唐 糖 汤 丧 盲 塘 趟 沧 烫 枉
盼	怕 盘 判 胖 栏 艳 燕 坎 尴 潘 叛 攀 晗 攒 帕
椒	交 较 叫 角 脚 缴 焦 胶 娇 骄 矫 搅 蕉 浇 轿
琪	七 汽 妻 骑 棋 契 歧 岂 祈 乞 琦 凄 绮 砌 迄
锡	西 喜 习 吸 媳 晰 稀 溪 夕 兮 茜 犀 烯 熄 嬉
舌	设 社 示 适 摄 舍 射 涉 氏 吓 厦 暑 蛇 奢 墅
捉	住 追 著 桌 卓 豁 佐 拙 灼 浊 辍 酌 镯 嚯 茁
嘲	号 照 超 差 朝 潮 烧 赵 炒 吵 耗 抄 缠 罩 巢
蒸	正 证 政 张 城 整 争 征 郑 症 衡 挣 呈 彰 拯
斥	直 吃 持 迟 池 尺 赤 痴 驰 齿 耻 侈 翅 炽 嗤
萝	活 或 落 罗 洛 逻 裸 啰 螺 囖 撸 卤 懦 烙 骆
伱	你 尼 忆 拟 紫 泥 逆 妮 埃 欸 腻 倪 霓 匿 昵
喵	表 教 笑 疗 猫 脚 描 貌 妙 秒 胶 苗 辽 庙 渺
掘	觉 具 据 决 剧 绝 爵 诀 崛 抉 倔 厥 獗 颉 孑
淋	李 林 临 邻 琳 赁 菱 榴 吟 彬 沦 麟 霖 吝 磷
卢	录 陆 绿 鲁 炉 碌 撸 芦 璐 卤 庐 禄 噜 泸 虏
蕾	内 位 类 累 雷 泪 勒 赖 玫 啡 磊 沸 莓 潍 垒
厢	想 相 像 强 向 象 项 显 响 香 享 乡 箱 详 陷
苯	本 问 门 北 般 背 贝 奔 喷 斑 闷 笨 碑 纹 卑
蠢	产 春 村 纯 沉 川 混 船 储 厨 趁 唇 锤 喘 醇
矩	车 剧 局 句 举 距 拒 俱 惧 菊 焗 橘 狙 鞠 驹
袁	原 院 元 远 源 愿 园 缘 圆 怨 援 苑 冤 渊 媛
扔	更 嗡 登 仍 腾 盟 缝 蜂 泵 绒 蹭 溶 梗 熔 檬
慌	欢 换 黄 皇 壮 荒 凰 唤 谎 煌 晃 恍 疮 惶 簧
昇	生 证 身 商 神 城 声 省 争 升 征 尚 胜 圣 剩
丫	亚 呀 压 雅 牙 押 涯 鸭 谊 吖 芽 讶 哑 鸦 崖
轰	红 送 恐 冬 宗 宏 洪 虹 泳 鸿 涌 葱 筒 桶 哄
勃	博 播 笔 波 佛 伯 卧 拨 玻 鄙 泼 搏 泊 驳 脖
莞	关 管 观 官 馆 惯 冠 钻 贯 灌 罐 棺 纶 竿 眷
悄	校 巧 桥 恰 乔 敲 喵 瞧 雀 撩 侨 翘 俏 窍 狡
袖	戏 修 秀 休 羞 绣 斜 瘤 玖 狭 畜 絮 锈 朽 嗅
孟	明 梦 盟 蒙 萌 恒 赠 猛 铭 蚌 冥 庚 懵 愣 檬
旨	之 知 只 直 制 质 智 止 织 纸 址 枝 滞 蜘 酯
垂	水 吃 慧 储 灰 迟 悔 吹 锤 戳 翅 橱 炊 捶 烩
婷	听 清 景 挺 停 庭 厅 订 兵 迎 堂 径 颖 亭 廷
潘	怕 盘 判 胖 栏 艳 燕 坎 尴 盼 叛 攀 晗 攒 帕
愧	快 亏 绘 馈 溃 葵 窥 盔 魁 奎 匮 悴 睢 傀 睽
捞	老 包 络 劳 毫 栏 遥 牢 膏 稻 螺 姥 佬 叨 唠
姚	要 约 套 药 摇 邀 腰 妖 耀 遥 咬 谣 岆 瑶 钥
韦	未 维 委 味 围 威 谓 慰 喂 胃 薇 魏 畏 潍 猥
鼎	定 听 星 顶 订 灯 聘 丁 铭 钉 盯 叮 卿 菱 伶
摔	说 水 视 税 睡 怀 坏 刷 帅 晒 耍 衰 甩 淮 筛
宴	验 严 烟 颜 炎 艳 燕 盐 沿 岩 掩 咽 衍 腌 堰
赴	服 复 付 父 富 附 符 幅 傅 伏 抚 腹 弗 辐 缚
匹	批 皮 屁 脾 疲 披 啤 劈 癖 痞 坯 霹 琵 媲 丕
沪	户 护 互 乎 湖 胡 虎 忽 糊 狐 壶 蝴 葫 弧 唬
蜡	拉 啦 礼 罚 鲁 娜 塔 赖 垃 辣 牢 腊 疤 碌 鸦
鑫	心 新 信 形 您 欣 辛 嘻 拼 劲 琴 薪 芯 腺 膝
腊	拉 啦 礼 罚 鲁 娜 塔 赖 垃 辣 牢 蜡 疤 碌 鸦
砸	再 哈 达 马 巴 压 杂 咯 娃 涯 躁 澡 祂 阀 喇
苑	原 院 元 远 源 愿 园 缘 圆 怨 援 袁 冤 渊 媛
侦	真 镇 针 珍 圳 震 阵 诊 甄 枕 帧 疹 臻 朕 斟
堕	多 堆 盾 盗 拖 扩 洛 措 夺 朵 哆 躲 妒 琢 魄
阁	个 格 歌 各 哥 革 隔 割 戈 葛 鸽 搁 嘎 褐 坷
叛	难 盘 判 胖 栏 燕 尴 盼 潘 攀 晗 攒 帕 拌 雁
呦	有 友 又 游 由 优 油 右 邮 尤 幼 幽 悠 犹 诱
稽	己 机 集 击 激 吉 辑 既 寂 忌 祭 饥 姬 嫉 脊
舟	主 手 周 首 州 洲 厚 兽 瘦 侯 宙 吼 骤 轴 咒
轩	选 宣 旋 悬 暅 炫 玄 萱 喧 渲 绚 璇 嬛 眩 漩
玥	月 越 却 雨 阅 玉 叶 悦 跃 岳 豫 喻 韵 浴 掘
募	目 母 努 府 密 木 幕 慕 姆 牧 墓 瑜 谜 穆 畜
鄙	比 笔 币 逼 避 闭 鼻 彼 壁 碧 弊 辟 臂 屄 痹
逢	更 风 份 曾 登 丰 封 峰 疼 疯 凤 锋 奉 缝 蜂
椅	意 艺 疑 译 遗 姨 疫 毅 绎 夷 裔 沂 壹 倚 咦
龟	规 贵 归 鬼 柜 轨 毁 醉 跪 瑰 桂 闺 硅 卦 崔
披	批 皮 屁 脾 疲 匹 啤 劈 癖 痞 坯 霹 琵 媲 丕
蝶	跌 邪 谐 裂 爹 蟹 携 皆 猎 泄 蒂 蝎 劣 歇 劫
咽	验 严 烟 颜 炎 艳 燕 盐 沿 岩 掩 宴 衍 腌 堰
吼	后 候 收 又 头 受 否 扣 偶 抽 厚 猴 侯 喉 搂
寨	海 找 值 择 债 炸 宅 芝 摘 旨 咳 肢 窄 肇 缀
鹰	应 影 英 营 硬 映 赢 盈 颖 樱 莹 荧 蝇 萤 莺
薛	学 解 续 血 询 雪 阅 鞋 讯 巡 泄 叙 岳 蝎 歇
裹	国 过 果 规 锅 郭 扩 洛 措 滚 稿 惑 撮 咕 呱
杠	房 刚 港 访 央 棒 钢 攻 岗 杭 仰 纲 纺 庞 痒
枚	没 美 位 费 每 米 妹 媒 梅 赔 煤 魅 眉 玫 霉
衬	称 陈 审 甚 纯 沉 晨 扯 尘 诊 辰 臣 趁 秤 甄
裕	于 预 遇 域 余 雨 宇 愉 郁 愚 寓 逾 瑜 舆 榆
胀	长 张 章 掌 账 涨 障 偿 帐 丈 肠 肿 仗 彰 樟
祭	己 机 集 击 激 吉 辑 既 寂 忌 稽 饥 姬 嫉 脊
泼	破 婆 默 魔 霸 坡 陌 脉 颇 蜗 趴 菩 珀 陂 坯
揪	就 九 究 句 即 酒 久 救 旧 纠 舅 浸 玖 韭 灸
撼	汉 韩 含 蓝 寒 涵 喊 汗 憾 函 旱 晗 焊 翰 罕
倪	你 尼 拟 紫 泥 逆 妮 埃 欸 腻 伱 霓 匿 昵 幂
殿	点 电 边 店 便 连 典 兼 迁 垫 颠 贬 淀 扂 巅
咪	米 依 礼 密 迷 秘 蜜 弥 谜 幂 泌 靡 曦 觅 眯
纤	现 限 县 鲜 献 闲 仙 陷 羡 咁 咸 掀 衔 腺 馅
磊	内 位 类 累 雷 泪 勒 赖 玫 黎 蕾 沸 莓 潍 垒
甩	说 水 视 税 睡 怀 坏 刷 帅 晒 耍 衰 摔 淮 筛
鹅	哦 额 恶 俄 呃 饿 噩 厄 鄂 遏 讹 扼 胺 峨 鳄
祂	他 她 图 它 达 塔 踏 瓦 鸭 叭 爬 塌 惕 咔 粑
骤	主 手 候 周 首 州 洲 守 厚 兽 瘦 宙 舟 轴 咒
秤	成 程 城 充 声 承 诚 盛 乘 昌 郑 撑 呈 肠 惩
爵	觉 具 据 决 剧 绝 掘 诀 崛 抉 倔 厥 獗 颉 孑
瑟	乐 色 呵 速 克 页 颗 荷 舌 鹅 涩 讷 忒 烨 鳄
兆	号 找 展 照 招 赵 召 耗 扎 罩 昭 爪 凿 肇 郝
亭	听 清 景 挺 停 庭 厅 订 兵 迎 堂 径 颖 婷 廷
倡	长 场 常 唱 厂 偿 昌 尝 畅 呈 肠 闯 敞 殇 憧
勿	五 物 午 武 舞 悟 乌 伍 呜 吾 巫 唔 坞 梧 捂
弊	比 笔 币 逼 避 闭 彼 壁 碧 鄙 辟 臂 屄 痹 陛
绎	意 艺 疑 译 遗 姨 疫 毅 椅 夷 裔 沂 壹 倚 咦
畏	未 维 委 味 围 威 谓 慰 喂 胃 薇 魏 惟 潍 猥
彭	等 朋 嗡 蒙 疯 瓶 碰 缝 蜂 捧 鹏 棚 坪 藤 磅
氨	安 完 班 干 演 案 按 兰 暗 胆 甘 岸 俺 鞍 揽
霜	装 伤 双 尚 床 赏 皇 妆 爽 凰 谎 疮 幢 惶 裳
溃	快 亏 馈 愧 龟 摧 葵 窥 盔 魁 奎 匮 悴 睢 傀
囊	放 男 房 杨 访 央 棒 洋 钢 仰 芒 旸 痒 沧 壤
塘	堂 羊 唐 糖 汤 盲 躺 趟 沧 烫 枉 棠 倘 淌 膛
霓	你 尼 拟 紫 泥 逆 妮 埃 欸 腻 伱 倪 匿 昵 幂
挽	完 万 玩 晚 盘 汉 湾 弯 碗 塆 丸 婉 顽 腕 宛
笼	东 统 龙 攻 隆 冻 桶 岭 轰 桐 垄 拢 怂 珑 聋
牲	生 声 省 升 胜 圣 症 剩 呈 昇 肾 绳 甸 殇 晟
轴	主 手 候 周 首 州 洲 守 厚 兽 瘦 宙 舟 骤 咒
弦	现 限 县 鲜 献 闲 仙 陷 羡 咁 咸 掀 衔 腺 馅
啪	妈 它 达 马 怕 跑 牙 扒 鸭 叭 爬 葩 帕 趴 蒲
闯	创 唱 川 床 尝 庄 妆 窗 爽 肠 谎 慌 倡 霜 晃
沫	模 默 魔 末 摩 莫 磨 摸 膜 墨 陌 脉 寞 抹 漠
儒	如 入 母 故 诉 付 吴 虎 予 乳 狱 腹 雾 辱 嘟
慨	开 外 买 才 卖 嘚 嘅 凯 哉 砍 坎 歹 佰 楷 窥
葡	普 武 夫 举 土 铺 谱 扑 浦 儒 醋 吾 菩 埔 仆
佣	用 永 拥 勇 庸 泳 涌 笼 匆 溶 咏 雍 嵩 甬 踊
翠	队 退 瑞 吹 腿 催 脆 粹 龟 崔 怼 贿 摧 萃 荟
匆	从 总 容 仓 聪 宋 孔 宠 隆 浓 葱 丛 瞳 咚 嵩
饥	己 机 集 击 激 吉 辑 既 寂 忌 稽 姬 嫉 脊 妓
栋	动 东 容 共 送 懂 龙 童 订 丁 冬 洞 聪 董 冻
勉	面 先 见 免 健 潜 敏 兼 迁 践 眠 棉 淀 绵 缅
塆	完 万 玩 晚 盘 汉 湾 弯 碗 挽 丸 婉 顽 腕 宛
禾	和 合 何 课 呵 河 核 喝 呼 射 隔 盒 荷 吓 赫
匿	你 尼 拟 紫 泥 逆 妮 埃 欸 腻 伱 倪 霓 昵 幂
疤	吧 八 把 报 哈 拿 爸 巴 避 娃 拔 芭 罢 叭 搏
搏	博 播 笔 波 闭 伯 卧 拨 玻 勃 鄙 泊 驳 脖 渤
丛	从 总 容 仓 聪 宋 孔 宠 隆 浓 葱 匆 瞳 咚 嵩
麽	模 默 魔 末 摩 莫 磨 摸 膜 墨 陌 脉 寞 抹 漠
碌	路 录 绿 鲁 炉 卢 芦 璐 卤 庐 禄 噜 泸 虏 麓
瘾	因 音 言 银 引 印 阴 隐 饮 姻 淫 吟 殷 尹 嫣
坝	吧 八 把 报 哈 拿 爸 巴 避 娃 拔 芭 罢 叭 疤
膏	高 导 告 搞 概 稿 糕 陶 堡 蹈 裹 嘎 镐 壕 皓
宪	现 限 县 鲜 献 闲 仙 陷 羡 咁 咸 掀 衔 腺 馅
宵	小 笑 消 销 效 晓 孝 肖 萧 削 潇 嚣 霄 硝 馅
惩	成 程 城 充 承 诚 盛 乘 昌 撑 呈 肠 辰 秤 甸
浆	量 将 讲 江 警 奖 竟 良 静 降 剑 兼 鉴 疆 姜
丘	求 球 救 旧 弃 秋 琴 秦 仇 舅 钮 邱 琦 凄 囚
灿	研 参 餐 暗 蛋 藏 残 懒 诞 惨 坎 尴 掩 蚕 惭
稻	到 道 导 倒 岛 刀 澳 旦 冒 傲 戴 胆 盗 呆 邀
咳	还 海 孩 载 牌 财 排 拍 害 择 哉 乃 摘 唻 抬
耕	更 登 港 疼 蒙 疯 缝 蜂 梗 庚 巩 枫 翁 耿 檬
侃	看 男 难 凡 颜 咱 刊 燃 摊 栏 堪 砍 坎 勘 衍
弗	服 付 父 富 府 附 符 幅 傅 伏 抚 腹 辐 缚 俯
靓	两 量 讲 亮 练 恋 奖 良 令 辆 梁 凉 粮 郎 谅
胁	些 解 谢 写 协 鞋 械 邪 谐 蟹 携 泄 蝎 歇 卸
贼	非 质 执 止 织 威 呗 魅 碑 蔚 昧 兹 巍 秩 媚
捣	到 道 导 倒 岛 刀 澳 旦 冒 傲 戴 胆 盗 呆 邀
趟	堂 羊 唐 糖 汤 躺 塘 沧 烫 枉 棠 倘 淌 膛 搪
丸	完 万 玩 晚 饭 范 湾 弯 碗 挽 塆 婉 顽 腕 宛
芒	帮 忙 央 棒 洋 钢 坊 茫 汪 盲 躺 沧 妄 烫 氓
钓	校 掉 娇 吊 孝 屌 雕 椒 悄 撩 飙 饺 婊 廖 刁
煎	见 简 坚 健 监 减 荐 键 鉴 尖 肩 舰 奸 箭 牋
捡	见 简 坚 健 监 减 荐 键 鉴 尖 肩 舰 奸 箭 牋
妃	费 非 备 飞 肥 菲 废 啡 肺 匪 沸 绯 翡 斐 扉
樱	应 影 英 营 硬 映 赢 盈 颖 婴 鹰 莹 荧 蝇 萤
诶	细 食 维 递 耳 挨 眉 沂 茜 脊 哩 壹 泌 熄 脐
妞	究 您 修 努 牛 逆 怒 柳 纽 扭 浏 绣 捏 瘤 玖
咸	现 先 线 限 险 县 鲜 献 闲 仙 陷 嫌 羡 纤 宪
埠	不 部 步 补 布 苦 播 负 捕 污 谱 怖 卜 簿 哺
吱	之 只 直 制 质 智 止 织 纸 址 枝 旨 滞 蜘 酯
擅	山 善 删 闪 汗 扇 陕 衫 颤 旱 珊 杉 汕 姗 煽
羯	结 姐 介 街 借 阶 杰 洁 截 揭 捷 戒 劫 桔 诫
嫩	分 本 文 问 认 难 跟 份 忍 森 喷 闷 笨 愤 苯
肾	真 身 神 深 申 审 甚 沈 伸 慎 渗 汕 绅 婶 赡
溢	意 艺 疑 译 遗 姨 疫 毅 椅 绎 夷 裔 沂 壹 倚
螺	落 罗 洛 逻 裸 啰 萝 囖 撸 卤 噜 烙 骆 锣 颅
颈	经 精 京 境 景 警 竟 惊 竞 镜 敬 径 晶 殑 荆
扂	点 电 边 店 便 典 潜 兼 迁 垫 颠 贬 淀 殿 巅
廷	听 清 统 亲 挺 停 庭 童 醒 厅 兵 迎 颖 婷 亭
囖	落 罗 洛 逻 裸 啰 萝 螺 撸 卤 噜 烙 骆 锣 颅
帆	反 干 言 饭 范 翻 烦 犯 凡 繁 返 泛 番 沿 贩
辟	比 笔 币 逼 避 闭 彼 壁 碧 鄙 弊 臂 屄 痹 陛
霆	听 清 统 亲 挺 停 庭 童 醒 厅 兵 迎 颖 婷 亭
鞍	安 完 班 干 演 案 按 兰 暗 蛮 胆 甘 岸 俺 氨
萄	早 造 套 讨 淘 邀 逃 桃 陶 涛 膏 捣 掏 苞 韬
撸	录 陆 绿 鲁 鹿 炉 卢 碌 芦 璐 卤 庐 禄 噜 泸
碟	跌 邪 谐 裂 爹 蟹 携 皆 猎 泄 蒂 蝎 劣 歇 劫
噶	哪 该 格 它 干 达 巴 孤 扒 爬 葛 尬 疤 坝 膏
钥	要 约 药 摇 邀 腰 妖 耀 遥 咬 谣 岆 瑶 姚 咽
崽	在 再 质 改 值 字 载 杂 拜 纸 灾 迫 遭 栽 宰
浑	论 婚 护 获 混 虎 挥 润 魂 憾 晕 昆 沪 昏 匀
蚀	十 事 实 市 试 使 失 识 士 石 势 室 诗 湿 饰
卵	乱 伦 券 幻 缘 圆 卷 链 患 缓 炼 览 烂 悬 锻
讽	风 份 粉 丰 封 峰 盟 疼 疯 凤 锋 奉 芬 缝 蜂
嗨	内 非 黑 河 谓 嘿 悔 啡 胃 磊 畏 禾 鹤 惟 酶
渔	于 预 遇 域 余 雨 宇 愉 郁 愚 寓 逾 瑜 舆 榆
瓣	办 帮 班 版 半 般 板 担 伴 探 坛 搬 颁 斑 扮
伞	三 山 班 干 演 淡 散 懒 诞 潘 宴 叛 咽 绊 悍
怡	意 艺 疑 译 遗 姨 疫 毅 椅 绎 夷 裔 沂 壹 倚
菊	车 具 据 剧 局 居 巨 聚 距 拒 拘 矩 焗 橘 狙
臂	比 笔 币 逼 避 闭 彼 壁 碧 鄙 弊 辟 屄 痹 陛
殑	经 精 京 境 景 警 竟 惊 竞 镜 敬 径 晶 颈 荆
叠	跌 邪 谐 裂 爹 蟹 携 皆 猎 泄 蒂 蝎 劣 歇 劫
雇	股 故 古 顾 估 鼓 固 骨 孤 姑 谷 辜 菇 咕 沽
旸	样 养 阳 杨 央 洋 扬 羊 仰 氧 痒 嗓 烊 秧 漾
吕	了 力 录 律 率 旅 虑 侣 璃 粒 履 滤 驴 铝 屡
唇	春 村 纯 沉 川 触 船 储 厨 缠 趁 蠢 锤 醇 淳
匙	十 事 实 市 试 使 失 识 士 石 势 室 诗 湿 饰
昏	论 婚 护 获 混 虎 挥 润 魂 憾 晕 昆 沪 浑 匀
冤	原 院 元 远 源 愿 园 缘 怨 援 袁 苑 渊 媛 猿
瞧	跳 巧 桥 恰 乔 敲 喵 悄 雀 撩 侨 翘 俏 窍 狡
泊	博 播 笔 波 闭 伯 卧 拨 玻 勃 鄙 搏 驳 脖 渤
於	于 预 遇 域 余 雨 宇 愉 郁 愚 寓 逾 瑜 舆 榆
粤	月 越 却 雨 阅 玉 叶 悦 跃 岳 豫 喻 韵 掘 玥
碳	谈 慢 弹 探 坛 坦 摊 贪 叹 滩 炭 烫 吞 谭 潭
勘	看 男 难 凡 颜 咱 刊 惨 燃 摊 堪 砍 坎 侃 衍
阐	产 纯 偿 昌 汗 缠 灿 禅 焊 馋 斩 蝉 掺 铲 盏
琐	所 错 索 锁 缩 洛 措 惑 夺 碎 霍 佐 琢 魄 梭
牺	西 喜 习 吸 媳 晰 稀 溪 夕 兮 茜 玺 犀 烯 嬉
棚	等 朋 嗡 蒙 疯 瓶 碰 缝 蜂 捧 鹏 彭 磅 蓬 膨
淮	欢 环 画 怀 坏 怪 灰 患 悔 恢 乖 衰 哗 卉 桓
枯	股 步 组 苦 顾 库 符 哭 酷 裤 赋 浴 缚 埔 溯
耽	但 单 担 严 餐 汉 翻 蛋 淡 丹 旦 胆 诞 氮 钝
蔚	位 未 维 委 味 卫 威 谓 违 尾 慰 伪 胃 薇 韦
哄	红 送 恐 冬 宗 宏 洪 虹 泳 鸿 涌 葱 筒 桶 轰
昧	没 美 买 位 每 米 妹 媒 梅 煤 魅 眉 玫 霉 枚
坤	员 云 困 库 讯 轮 俊 昆 阔 敦 馈 蕴 垮 峻 芸
姥	老 报 造 络 跑 劳 赖 矛 牢 捞 佬 拦 唠 袍 烙
拐	关 该 管 规 块 概 坏 怪 盖 轨 跪 瑰 乖 闺 灌
葩	它 达 马 怕 跑 牙 扒 鸭 叭 爬 啪 帕 趴 蒲 噗
硅	规 贵 估 归 鬼 柜 轨 跪 瑰 桂 闺 龟 卦 崔 诡
郊	教 交 校 叫 角 脚 缴 焦 胶 娇 骄 椒 矫 搅 蕉
仗	长 张 战 章 掌 账 涨 征 障 帐 丈 肠 肿 胀 彰
纺	方 放 房 养 往 防 访 仿 芳 脏 挡 坊 妨 逢 杠
搁	个 格 歌 各 哥 革 隔 割 戈 葛 鸽 阁 菇 噩 坷
罐	关 管 观 官 馆 惯 冠 钻 贯 灌 莞 棺 纶 竿 眷
罩	号 找 展 照 招 赵 召 耗 扎 诈 兆 昭 爪 凿 肇
扁	变 先 见 片 便 健 签 篇 骗 偏 潜 兼 迁 践 淀
韧	人 认 任 份 忍 奔 仁 染 喷 吻 苯 壬 刃 恳 垦
驳	博 播 笔 波 闭 伯 卧 拨 玻 勃 鄙 搏 泊 脖 渤
滩	谈 弹 探 坛 坦 摊 贪 叹 碳 炭 烫 吞 谭 潭 毯
庞	帮 朋 王 港 瓶 糖 旁 汤 胖 仿 萍 葬 廊 拌 坪
阀	发 法 亚 怕 饭 附 罚 乏 伏 覆 伐 祂 哑 靶 鸦
鹤	和 合 何 课 呵 河 核 喝 叶 隔 盒 荷 吓 赫 贺
刮	估 挂 锅 跨 瓜 夸 桂 莞 雇 棍 卦 寡 呱 褂 帼
蚌	更 丰 恒 坑 崩 蹦 泵 枫 翁 藤 蓬 懵 膨 绷 甭
誓	十 事 实 市 试 使 失 识 士 石 势 室 诗 湿 饰
壬	人 本 认 任 份 忍 奔 仁 染 喷 吻 扔 韧 刃 恳
涩	格 科 社 各 色 似 河 刻 夜 核 舍 盒 瑟 禾 鹤
攀	怕 盘 判 胖 栏 燕 坎 尴 盼 潘 叛 晗 攒 帕 拌
渊	原 院 元 远 源 愿 园 缘 怨 援 袁 苑 冤 媛 猿
峡	下 谢 吸 佳 夏 侠 瞎 霞 虾 辖 锡 宵 胁 狭 暇
贞	真 镇 针 珍 圳 震 阵 诊 振 侦 甄 枕 帧 疹 臻
橙	等 更 登 顶 灯 盟 疼 邓 缝 蜂 捧 冯 澄 藤 蓬
狸	买 太 百 再 该 改 卖 态 害 麦 栽 迈 乃 霉 谜
肢	之 知 只 直 制 质 智 织 纸 址 枝 旨 滞 蜘 酯
丙	请 并 病 冰 兵 屏 凌 饼 泵 钉 莹 秉 柄 濒 炳
澄	当 等 登 灯 仍 碰 邓 彭 耕 橙 蹭 盯 耿 懵 凳
佬	老 报 造 络 倒 跑 劳 赖 矛 糕 牢 捞 姥 拦 唠
寝	引 切 琴 勤 侵 秦 栖 倩 吟 彬 崎 嵌 钦 禽 沁
斌	音 近 边 版 遍 避 欣 宾 碧 滨 饼 辨 谨 彬 尹
佑	有 友 又 游 由 优 油 右 邮 尤 幼 幽 悠 犹 诱
窃	且 器 却 切 伽 茄 妾 怯 惬 榭 矜 沏 裘 酋 蹊
刃	人 认 任 份 粉 忍 奔 仁 染 喷 吻 苯 扔 韧 壬
蔬	书 属 述 树 舒 叔 殊 暑 鼠 署 疏 梳 抒 赎 薯
煌	黄 床 皇 荒 凰 谎 慌 晃 恍 桓 疮 幢 惶 簧 潢
庙	教 漂 晓 描 妙 秒 矛 朴 苗 喵 搅 渺 翘 僚 瞄
贩	反 言 份 饭 范 翻 烦 犯 凡 繁 返 泛 番 沿 帆
痒	样 营 养 阳 杨 央 洋 扬 羊 仰 氧 旸 烊 秧 漾
炭	谈 慢 弹 探 坛 坦 摊 贪 叹 碳 滩 吞 谭 潭 毯
蹦	更 丰 恒 坑 崩 蚌 泵 枫 翁 藤 蓬 懵 膨 绷 甭
旭	需 许 续 须 序 虚 绪 徐 蓄 叙 畜 絮 恤 婿 墟
匠	量 将 象 讲 江 警 奖 良 静 降 剑 兼 鉴 疆 姜
绣	续 戏 修 秀 休 羞 袖 揪 旭 斜 瘤 玖 狭 絮 锈
茅	包 毛 猫 贸 貌 冒 矛 浩 帽 冇 茂 昊 噪 韬 髦
辙	这 着 者 查 折 喆 哲 浙 竹 蛇 枝 振 赫 遮 烛
沧	望 藏 洋 钢 仓 杭 仰 昂 狼 惨 苍 痒 妄 烫 舱
掏	早 造 套 讨 淘 邀 逃 桃 陶 涛 膏 捣 萄 苞 韬
喽	流 路 头 楼 录 露 豆 陆 扣 搜 透 漏 炉 陋 搂
曰	月 越 却 雨 阅 玉 叶 悦 跃 岳 豫 喻 韵 浴 掘
吨	困 蛋 毒 损 顿 盾 敦 逊 裙 蹲 芸 镀 囤 舵 笋
丶	主 助 祝 筑 猪 逐 竹 驻 煮 株 嘱 铸 诛 蛛 瞩
穴	学 解 续 血 询 雪 阅 鞋 讯 巡 泄 叙 岳 蝎 歇
鞭	建 变 边 简 编 遍 辩 辨 奸 贱 贬 奠 绊 帘 掂
斜	些 解 谢 写 协 鞋 械 邪 谐 蟹 携 泄 蝎 歇 卸
捏	解 接 结 介 妮 猎 泄 蝎 劣 纽 歇 劫 泻 孽 讷
豁	活 化 或 户 货 火 获 伙 滑 惑 霍 祸 沪 嗦 蒿
嫂	赛 暴 遭 稿 扫 遥 曹 骚 钥 敖 皂 幺 祷 哨 袄
堤	地 第 低 底 弟 递 帝 滴 迪 抵 敌 蒂 笛 旳 缔
浸	进 金 今 近 尽 仅 紧 津 禁 劲 斤 锦 肩 谨 晋
酉	有 友 又 游 由 优 油 右 邮 尤 幼 幽 悠 犹 诱
棍	故 冠 滚 韵 浑 雇 昏 坤 硅 罐 刮 吨 卦 吞 蕴
雀	巧 桥 胶 乔 敲 悄 瞧 侨 翘 俏 掐 窍 淆 筱 哮
滞	之 只 直 制 质 治 智 止 织 纸 址 枝 旨 蜘 酯
绳	生 正 声 省 承 争 升 胜 圣 剩 呈 蒸 昇 牲 甸
敷	付 父 富 附 妇 符 幅 傅 伏 抚 腹 弗 辐 缚 俯
妄	网 望 玩 帮 王 往 忘 唐 亡 糖 旁 汤 仿 旺 汪
笛	地 第 低 底 弟 递 帝 滴 迪 抵 敌 蒂 堤 旳 缔
兹	自 子 资 字 咨 紫 姿 滋 孜 籽 淄 梓 疵 呲 渍
卦	关 华 股 归 怪 挂 谷 滚 瓜 瑰 龟 拐 硅 罐 刮
烫	堂 羊 唐 糖 汤 荡 躺 塘 趟 霆 谭 枉 乓 棠 倘
吞	团 村 谈 困 迅 徒 俊 叹 循 菌 陀 毯 屯 臀 褪
侈	吃 持 迟 池 尺 赤 痴 驰 齿 耻 斥 翅 锄 炽 嗤
崔	队 退 瑞 吹 腿 绘 催 脆 粹 翠 怼 贿 摧 萃 荟
诵	红 共 送 供 融 松 宋 泳 讼 轰 颂 雍 嵩 怂 耸
燥	保 早 造 搞 倒 岛 盗 遭 槽 牢 糟 躁 澡 兆 罩
逾	于 预 遇 域 余 雨 宇 愉 郁 愚 寓 裕 瑜 舆 榆
锤	水 吃 慧 储 灰 迟 悔 吹 垂 戳 翅 橱 炊 捶 烩
倭	我 播 握 佛 魔 卧 窝 沃 脉 涡 伍 玻 喔 敖 蜗
赁	林 尽 临 邻 琳 淋 澜 菱 榴 吟 帘 麟 霖 吝 磷
蓉	容 融 痛 童 拥 松 荣 笼 佣 匆 绒 溶 桐 垄 壤
瑜	于 预 遇 域 余 雨 宇 愉 郁 愚 寓 裕 逾 舆 榆
蛾	意 艺 疑 译 遗 姨 疫 毅 椅 绎 夷 裔 沂 壹 倚
冇	包 宝 毛 猫 闹 贸 貌 冒 矛 浩 帽 茅 茂 昊 噪
甸	生 正 声 省 承 争 升 胜 圣 剩 呈 蒸 昇 牲 绳
喉	后 候 游 户 由 周 楼 厚 丑 忧 忽 猴 痘 侯 吼
巍	位 未 维 委 味 卫 威 谓 违 尾 慰 伪 喂 胃 薇
衫	深 山 善 删 闪 汗 扇 陕 擅 珊 杉 汕 姗 煽 讪
颂	红 共 送 供 融 松 宋 泳 讼 轰 诵 雍 嵩 怂 耸
滥	眼 般 兰 蓝 览 烂 懒 篮 栏 唻 肝 琳 拦 澜 揽
佐	作 做 错 座 左 坐 租 索 昨 洛 措 桌 遭 惑 夺
谜	米 依 礼 密 迷 秘 蜜 弥 咪 幂 泌 靡 觅 羁 琦
奕	意 艺 疑 译 遗 姨 疫 毅 椅 绎 夷 裔 沂 壹 倚
砂	使 失 识 啥 杀 沙 傻 厦 晒 纱 莎 屎 扇 逝 疏
泵	更 丰 恒 坑 崩 蚌 蹦 枫 翁 藤 蓬 懵 膨 绷 甭
潇	小 笑 消 销 效 晓 孝 屌 肖 萧 削 宵 嚣 霄 硝
芦	路 录 绿 鲁 鹿 炉 卢 碌 撸 璐 卤 庐 禄 噜 泸
椰	也 业 夜 爷 野 页 叶 液 耶 涩 曰 冶 噎 烨 琊
婉	完 万 玩 晚 范 湾 弯 碗 挽 塆 丸 滥 顽 腕 宛
钉	定 听 清 顶 订 龄 灯 聘 映 丁 鼎 盯 叮 卿 菱
谭	谈 慢 弹 探 坛 坦 摊 贪 叹 碳 滩 炭 烫 潭 毯
钩	友 候 够 购 构 狗 沟 勾 呦 吼 雇 苟 逅 垢 鸥
瘤	六 流 历 留 刘 漏 裂 黎 柳 浏 溜 榴 灸 陋 硫
雯	文 问 微 温 卫 粉 闻 稳 纷 纹 吻 畏 挽 丸 蚊
凸	图 足 句 土 突 途 宿 屋 欲 促 吐 徒 兔 涂 叙
醋	顾 族 舞 鱼 促 粗 崔 逾 瑜 凸 妒 吾 舆 巫 辜
蕴	员 运 云 孕 允 晕 韵 匀 殷 熏 芸 酝 耘 陨 昀
衍	验 严 延 炎 燕 盐 沿 岩 掩 宴 咽 彦 妍 腌 堰
颤	展 张 照 站 战 占 闪 炸 粘 詹 沾 斩 窄 肇 憨
玖	就 九 究 酒 久 救 旧 既 纠 舅 揪 韭 灸 钮 疚
茂	包 宝 毛 猫 闹 贸 貌 冒 矛 浩 帽 茅 冇 昊 噪
嘘	十 事 什 实 试 失 识 士 适 石 势 室 释 狮 尸
秩	之 知 只 直 质 治 智 止 织 纸 址 枝 旨 滞 蜘
媚	没 美 每 妹 媒 梅 菲 煤 魅 碑 眉 玫 霉 枚 昧
旱	担 汉 韩 含 寒 涵 喊 汗 憾 函 撼 氨 晗 焊 翰
汰	太 台 态 败 哎 泰 胎 桃 哀 癌 抬 亥 毯 暧 逮
狭	下 谢 吸 佳 夏 侠 瞎 霞 虾 辖 锡 宵 胁 峡 暇
稚	之 知 只 直 质 治 智 止 织 纸 址 枝 旨 滞 蜘
绒	容 融 童 拥 松 荣 浓 笼 佣 匆 蓉 溶 垄 壤 熔
肆	四 司 思 死 斯 食 似 丝 私 肌 撕 寺 饲 嘶 厮
晗	担 汉 韩 含 寒 涵 喊 汗 憾 函 俺 撼 旱 焊 翰
嗒	大 打 单 达 答 呀 搭 罚 娜 塔 哒 稻 黛 睹 怠
啤	被 批 皮 屁 脾 疲 匹 劈 癖 痞 坯 霹 琵 媲 丕
遣	前 钱 千 签 潜 迁 欠 歉 谦 铅 乾 嵌 谴 黔 钳
妒	都 度 读 独 顾 舞 毒 督 杜 赌 肚 渡 堵 逾 嘟
铅	前 钱 千 签 潜 迁 欠 歉 谦 遣 乾 嵌 谴 黔 钳
吾	五 物 午 武 舞 悟 乌 伍 呜 勿 巫 唔 坞 梧 捂
舆	于 预 遇 域 余 雨 宇 愉 郁 愚 寓 御 裕 逾 瑜
弘	红 送 恐 冬 宗 宏 洪 虹 泳 鸿 涌 葱 筒 桶 轰
巫	五 无 物 午 武 舞 悟 乌 伍 呜 勿 吾 唔 坞 梧
辜	股 故 古 顾 估 鼓 固 骨 姑 谷 雇 菇 咕 沽 箍
攒	言 站 早 案 造 参 战 赞 凡 咱 暂 碗 宰 哉 蔓
赐	次 此 词 急 笔 益 依 礼 击 材 刺 辞 唉 圾 磁
帕	它 达 马 怕 跑 牙 扒 鸭 叭 爬 啪 葩 趴 蒲 噗
禅	产 纯 昌 删 船 汗 缠 灿 阐 焊 馋 蝉 掺 铲 盏
蹭	等 层 藏 封 蒙 疯 奉 赠 秤 彭 匆 丛 惩 耕 蚌
唔	五 无 物 午 武 舞 悟 乌 伍 呜 勿 吾 巫 坞 梧
莹	应 影 英 营 迎 硬 映 赢 盈 颖 婴 鹰 樱 荧 蝇
袜	妈 它 达 马 吴 娃 挖 哇 瓦 鸭 叭 雾 爬 喔 尬
磕	可 科 客 课 克 苦 刻 颗 渴 壳 柯 棵 苛 坷 珂
詹	展 张 传 照 站 战 占 炸 粘 颤 沾 斩 窄 肇 憨
盯	定 听 清 顶 订 龄 灯 聘 映 丁 鼎 钉 叮 卿 菱
扳	办 帮 班 版 半 般 板 伴 探 坛 搬 颁 斑 扮 氨
冶	也 业 越 夜 爷 野 页 叶 液 泽 耶 椰 噎 讹 烨
尉	于 预 遇 域 余 雨 宇 愉 郁 愚 寓 裕 逾 瑜 舆
溶	容 融 童 拥 松 荣 浓 笼 佣 匆 蓉 绒 垄 壤 熔
荆	经 精 京 境 景 警 竟 惊 竞 镜 敬 径 晶 颈 殑
萍	平 影 请 并 评 病 硬 竞 聘 凭 瓶 苹 凌 钉 盯
葬	仓 亡 仿 荡 邦 绑 帐 杭 脏 磅 缸 枉 嗓 舱 扛
嘎	歌 亚 怕 赶 谷 隔 涯 杆 尬 蜡 腊 祂 噶 喇 蛤
滤	力 拉 律 率 旅 虑 辣 侣 粒 履 吕 驴 铝 屡 吏
晃	黄 床 皇 荒 凰 谎 慌 煌 恍 桓 疮 幢 惶 簧 潢
梳	书 术 熟 述 树 舒 叔 殊 暑 疏 抒 赎 薯 墅 蜀
挚	之 知 直 质 治 智 止 织 纸 址 枝 旨 滞 蜘 酯
秉	请 并 病 冰 兵 屏 凌 饼 丙 泵 钉 莹 柄 濒 炳
穆	目 母 努 府 密 木 幕 慕 姆 牧 墓 募 瑜 畜 亩
夷	意 艺 疑 译 遗 姨 疫 毅 椅 绎 裔 沂 壹 倚 咦
姬	计 级 及 集 即 积 急 激 纪 鸡 吉 剂 肌 挤 忌
叨	到 道 导 倒 岛 刀 澳 旦 冒 傲 戴 胆 盗 呆 邀
匪	费 非 飞 肥 菲 废 啡 肺 妃 惟 沸 绯 酚 翡 斐
梗	更 刚 登 港 疼 疯 缝 蜂 耕 庚 巩 枫 翁 耿 檬
寡	估 挂 锅 跨 柜 瓜 夸 贯 跪 桂 莞 雇 刮 卦 呱
巷	想 相 像 向 形 象 项 响 香 享 乡 箱 详 翔 祥
吖	亚 呀 压 雅 牙 押 涯 鸭 叭 丫 芽 讶 哑 幺 鸦
畜	需 许 续 须 序 雪 虚 绪 徐 蓄 叙 旭 絮 恤 婿
沾	展 张 传 照 站 战 占 炸 粘 颤 詹 斩 窄 憨 帧
刹	使 失 识 啥 杀 沙 傻 厦 晒 纱 莎 屎 扇 逝 疏
彰	长 张 战 章 掌 账 涨 征 障 偿 妆 帐 丈 肿 胀
渝	于 语 育 愉 郁 羽 愚 狱 愈 寓 俞 吁 钰 禺 芋
旬	训 询 寻 讯 迅 循 巡 逊 勋 沦 熏 钝 绚 驯 薰
舔	天 钱 篇 典 田 填 仙 甜 添 殿 纤 勉 恬 惦 柬
焊	航 汉 韩 含 寒 涵 喊 汗 憾 函 俺 撼 旱 晗 翰
镐	高 导 告 络 搞 概 稿 糕 陶 堡 蹈 裹 膏 嘎 壕
驴	里 力 拉 律 率 旅 虑 侣 履 吕 滤 铝 屡 吏 缕
蔽	比 笔 币 逼 避 闭 彼 壁 碧 鄙 弊 辟 臂 屄 庇
咏	用 永 痛 拥 勇 庸 婴 泳 涌 笼 佣 溶 雍 嵩 甬
廊	浪 朗 仿 懒 狼 郎 垄 澜 菱 磅 琅 肮 梆 咙 斓
矫	教 交 校 较 叫 角 脚 缴 焦 胶 娇 骄 椒 搅 蕉
嫉	计 级 及 集 即 积 急 激 纪 鸡 吉 剂 肌 挤 忌
琢	作 做 错 座 左 坐 租 索 昨 洛 措 桌 遭 惑 夺
岂	七 汽 妻 旗 骑 棋 契 歧 琪 祈 乞 琦 凄 祁 绮
棵	可 科 客 课 克 刻 颗 渴 壳 柯 磕 苛 坷 珂 嗝
菇	股 故 古 顾 估 鼓 固 骨 孤 谷 雇 辜 咕 沽 箍
絮	需 许 续 须 序 虚 绪 徐 蓄 叙 旭 畜 恤 婿 墟
冥	明 名 影 民 请 命 硬 竞 龄 晶 凌 鸣 铭 秉 茎
庚	更 刚 登 港 疼 疯 缝 蜂 耕 梗 巩 枫 翁 耿 檬
拌	盘 判 残 胖 栏 艳 燕 尴 盼 潘 叛 攀 晗 帕 雁
钙	外 才 太 该 改 概 盖 赖 碍 慨 膏 咳 黛 逮 丐
琼	请 强 清 青 轻 庆 雄 穷 熊 倾 胸 囧 凶 晴 卿
魄	错 退 罗 坐 托 脱 吐 拖 扩 惑 夺 拓 妥 吞 佐
蚊	文 问 微 温 卫 粉 闻 稳 纷 纹 吻 畏 挽 丸 雯
勋	训 询 寻 讯 迅 循 巡 逊 旬 沦 熏 钝 绚 驯 薰
拯	正 证 政 整 争 涨 征 震 郑 症 忠 挣 肿 蒸 绳
芽	亚 呀 压 雅 牙 罚 押 涯 鸭 谊 丫 吖 讶 哑 幺
叮	定 听 清 顶 订 龄 灯 聘 映 丁 铭 鼎 钉 盯 卿
靖	经 精 京 境 景 警 惊 竞 镜 敬 睛 径 晶 颈 殑
桐	同 通 统 痛 童 综 铜 筒 桶 躺 彤 瞳 耸 珑 捅
簿	不 部 步 补 布 苦 爸 播 负 捕 污 怖 卜 埠 哺
镶	想 相 像 向 象 项 响 香 享 醒 乡 箱 详 枪 翔
戳	或 超 纯 朝 储 卓 豁 锤 烁 灼 辍 绰 镯 炊 矗
剖	走 奏 忧 柔 犹 兜 葡 佑 喽 喉 陋 揍 邹 仆 蒲
垄	总 龙 弄 孔 凌 隆 涌 笼 彤 嵩 拢 珑 聋 伶 胧
拦	兰 判 蓝 览 烂 懒 篮 栏 沿 函 埋 滥 拌 澜 揽
巢	号 超 操 朝 潮 烧 炒 稍 召 吵 浩 抄 嘲 阐 罩
蚕	干 研 参 餐 暗 蛋 藏 残 懒 诞 惨 尴 掩 踩 灿
脖	博 播 笔 波 闭 伯 卧 拨 玻 勃 鄙 搏 泊 驳 渤
昭	号 找 展 照 招 赵 召 耗 扎 兆 罩 爪 凿 肇 斋
掀	现 限 县 鲜 献 闲 仙 陷 嫌 羡 咁 宪 咸 衔 腺
疟	女 呢 略 虐 薛 倪 鹅 爵 瑟 霓 妞 羯 搁 鹤 捏
巩	工 公 功 共 供 综 攻 宫 贡 恭 筒 桶 讼 轰 弓
咧	留 列 烈 裂 猎 劣 膊 戾 偕 秸 丿 镍 遴 砾 拮
枫	风 丰 封 灯 峰 疯 凤 锋 奉 崩 猛 缝 蜂 冯 逢
韭	就 九 究 酒 久 救 旧 纠 仇 舅 揪 玖 灸 钮 疚
豹	保 报 办 包 宝 巴 讨 抱 爆 暴 薄 饱 堡 剥 胞
翁	往 温 嗡 峰 碰 亡 崩 汪 猛 逢 妄 蓬 朦 紊 噔
甄	真 镇 针 珍 圳 震 阵 诊 振 侦 枕 帧 疹 臻 朕
坪	平 影 请 并 评 病 硬 竞 聘 凭 瓶 苹 凌 钉 盯
隶	理 里 力 利 立 历 离 礼 黎 莉 厘 璃 栗 哩 沥
衔	现 限 县 鲜 献 闲 仙 陷 嫌 羡 咁 宪 咸 掀 腺
馋	产 纯 昌 删 船 汗 缠 灿 阐 禅 焊 蝉 掺 铲 盏
竭	接 结 姐 街 借 届 杰 洁 截 揭 捷 戒 皆 劫 桔
翰	玩 航 汉 韩 含 寒 涵 喊 汗 憾 函 撼 旱 晗 焊
淑	书 术 属 熟 述 输 树 舒 叔 殊 署 疏 蔬 梳 抒
澜	兰 判 蓝 览 烂 懒 篮 栏 沿 函 埋 滥 拌 拦 揽
弈	意 艺 疑 译 遗 姨 疫 毅 椅 绎 夷 沂 壹 倚 咦
罕	玩 航 汉 韩 含 寒 涵 喊 汗 憾 函 杆 撼 旱 晗
乾	前 钱 千 签 潜 迁 欠 牵 歉 谦 遣 铅 嵌 谴 黔
枣	保 早 造 搞 倒 岛 盗 逃 遭 槽 抛 牢 糟 躁 澡
睁	正 证 政 整 争 征 震 郑 症 忠 挣 肿 蒸 绳 甸
潭	谈 慢 弹 探 坛 坦 摊 贪 叹 碳 滩 炭 烫 谭 毯
咒	主 周 住 州 洲 朱 煮 宙 舟 骤 轴 丶 烛 粥 皱
卿	情 请 强 清 亲 青 轻 庆 竞 倾 晴 鼎 萍 擎 氢
菱	零 领 兴 另 灵 令 龄 凌 玲 铃 陵 岭 聆 伶 拎
屑	些 解 谢 写 协 械 邪 谐 蟹 携 泄 蝎 歇 卸 胁
瞒	满 范 慢 漫 贸 蛮 曼 番 埋 迈 肝 滥 婉 谭 衍
搅	教 交 较 叫 角 缴 焦 胶 娇 骄 椒 矫 蕉 浇 轿
惟	位 微 未 维 味 卫 谓 违 尾 慰 伪 喂 胃 薇 韦
祈	起 其 七 汽 弃 妻 旗 骑 棋 契 岂 琦 凄 祁 脐
藤	等 更 风 腾 盟 疼 廷 霆 讽 棚 蚌 愣 亨 甭 瞳
祎	意 艺 疑 译 遗 姨 疫 毅 椅 绎 夷 沂 壹 倚 咦
襄	想 相 像 向 象 项 响 香 享 醒 乡 箱 详 翔 祥
腺	现 线 限 险 显 县 鲜 献 闲 仙 陷 嫌 贤 宪 咸
磅	帮 朋 王 港 瓶 糖 旁 汤 胖 仿 庞 萍 葬 廊 拌
伽	且 器 却 切 窃 茄 妾 怯 蔑 惬 榭 矜 沏 裘 酋
铝	里 力 历 拉 律 率 旅 虑 侣 履 吕 滤 驴 屡 吏
珊	山 善 删 闪 汗 扇 陕 擅 衫 杉 悍 汕 姗 煽 讪
壶	户 互 乎 湖 呼 胡 虎 忽 糊 狐 沪 蝴 葫 弧 唬
屠	图 股 步 土 突 顾 途 偷 玉 俗 祖 吐 徒 兔 涂
茨	次 此 词 急 笔 益 依 礼 击 材 刺 辞 圾 磁 慈
恳	任 客 肯 温 恩 困 稳 忍 仁 壳 昆 愤 吻 盆 坎
倦	检 坚 官 健 监 端 圈 卷 捐 劵 娟 眷 柬 嬛 篡
芙	服 复 付 父 富 附 符 幅 傅 伏 抚 腹 弗 辐 缚
榴	六 流 历 留 刘 漏 黎 莉 柳 浏 溜 瘤 灸 陋 硫
梭	所 错 苏 索 锁 缩 洛 措 惑 夺 扫 霍 琐 嫂 琢
撰	专 展 转 传 站 穿 赚 抓 妆 患 砖 粘 颤 沾 栈
蕉	交 较 叫 角 脚 缴 焦 胶 娇 骄 椒 矫 搅 浇 轿
擎	情 请 清 亲 青 轻 庆 竞 倾 晴 鹰 萍 卿 氢 穹
挪	做 果 左 若 伙 诺 拖 洛 措 妥 奴 裹 螺 佐 懦
翅	吃 持 止 织 迟 池 尺 赤 痴 驰 齿 耻 斥 旨 侈
灸	就 九 究 酒 久 救 旧 纠 仇 舅 揪 玖 韭 钮 疚
泣	起 其 七 汽 弃 妻 旗 骑 棋 契 岂 祈 琦 凄 祁
栖	起 其 七 汽 弃 妻 旗 骑 棋 契 岂 祈 琦 凄 祁
倩	前 千 签 潜 迁 欠 牵 谦 遣 铅 乾 嵌 谴 黔 钳
饶	保 报 络 搞 弱 逃 遭 稿 扰 燃 遥 恼 剥 绕 糙
榆	于 语 育 愉 郁 羽 愚 狱 愈 寓 俞 吁 钰 禺 芋
烛	主 助 祝 筑 猪 逐 珠 竹 驻 柱 煮 丶 株 嘱 铸
蓬	更 朋 曾 层 登 灯 聘 碰 萌 崩 捧 鹏 扔 彭 棚
昵	你 尼 拟 紫 泥 逆 妮 埃 欸 腻 伱 倪 霓 匿 幂
躯	去 区 取 曲 趣 趋 驱 屈 渠 叙 娶 佢 睹 祛 蛆
屡	里 力 历 律 率 旅 虑 侣 履 吕 滤 驴 铝 吏 缕
牋	见 简 检 坚 健 减 荐 践 鉴 尖 肩 舰 奸 碱 歼
浇	教 交 较 叫 角 缴 焦 胶 娇 骄 椒 矫 搅 蕉 轿
亩	目 母 顾 鱼 木 苏 幕 慕 姆 牧 墓 募 敷 逾 瑜
渗	身 神 深 称 申 审 甚 舍 沈 尘 瞬 伸 慎 肾 汕
楠	男 难 南 演 研 满 版 晚 弹 湾 沿 函 杆 堪 腕
璟	经 精 境 景 警 静 惊 竞 镜 净 敬 睛 晶 井 颈
霾	买 太 百 再 该 改 卖 态 害 麦 栽 迈 乃 霉 狸
彦	验 严 延 炎 燕 盐 沿 岩 掩 宴 咽 衍 妍 腌 堰
粥	周 州 助 洲 守 朱 竹 煮 侯 宙 舟 骤 轴 喉 咒
杉	山 善 删 闪 汗 扇 陕 擅 衫 珊 悍 汕 姗 煽 讪
歹	代 带 导 改 待 嘚 贷 哎 搭 戴 呆 袋 哀 栽 黛
嚎	好 海 号 药 豪 潮 貌 毫 傲 耗 浩 凹 烤 昊 壕
匀	员 运 云 阅 孕 允 晕 韵 蕴 芸 酝 耘 陨 昀 熨
枕	真 镇 针 珍 圳 震 阵 诊 振 侦 贞 甄 帧 疹 臻
缸	房 刚 港 访 央 棒 钢 攻 岗 杭 仰 纲 杠 纺 庞
吟	因 音 银 引 印 阴 隐 饮 姻 抑 淫 瘾 殷 尹 茵
怼	对 队 随 鬼 嘴 滴 堆 醉 兑 堵 堤 笛 崔 逮 惰
坞	五 无 物 舞 吴 悟 伍 呜 勿 吾 巫 唔 梧 捂 毋
饵	二 而 儿 哦 尔 额 恶 恩 耳 饿 鹅 诶 厄 遏 贰
彬	音 近 边 版 遍 避 欣 宾 碧 滨 饼 辨 谨 斌 尹
弓	工 公 功 共 供 综 攻 宫 贡 恭 筒 桶 讼 轰 巩
侍	十 事 什 实 试 世 式 使 失 士 适 石 势 释 湿
抒	数 书 术 属 述 树 舒 叔 殊 暑 鼠 署 疏 蔬 赎
懈	些 解 谢 写 协 鞋 械 邪 谐 蟹 携 泄 蝎 歇 卸
讶	亚 呀 压 雅 牙 罚 押 涯 鸭 丫 吖 芽 哑 幺 鸦
赎	数 书 术 属 述 树 舒 叔 殊 暑 鼠 署 疏 蔬 抒
哗	话 化 花 华 婚 画 划 互 呼 虎 挥 滑 魂 辉 昏
斩	展 张 传 照 查 站 战 占 粘 颤 詹 沾 窄 蝉 帧
褐	和 合 何 呵 河 核 喝 呼 叶 射 隔 盒 荷 吓 赫
旳	地 第 低 底 弟 递 帝 滴 迪 抵 敌 蒂 堤 笛 缔
撩	交 料 聊 疗 漂 牢 飘 苗 辽 寥 廖 僚 逍 烙 绞
皱	注 周 州 洲 筑 朱 煮 侯 宙 舟 骤 轴 咒 粥 株
耿	更 登 港 疼 蒙 疯 缝 蜂 耕 梗 庚 巩 枫 翁 檬
飙	表 交 报 标 叫 效 料 挑 缴 晓 胞 朴 彪 俏 婊
坟	分 费 份 粉 恩 丰 奋 菲 纷 笨 氛 奉 愤 芬 粪
虞	于 语 育 愉 郁 羽 愚 狱 愈 寓 俞 吁 钰 禺 芋
妍	验 严 延 炎 燕 盐 沿 岩 掩 宴 咽 衍 彦 腌 堰
佢	去 区 取 曲 趣 趋 驱 屈 渠 肃 叙 娶 躯 睹 祛
沦	论 轮 绿 损 伦 混 逻 允 菌 逊 裙 旬 拦 仑 禄
昔	西 喜 习 吸 媳 晰 稀 溪 夕 兮 茜 犀 烯 嬉 羲
柄	请 并 病 冰 兵 屏 凌 饼 丙 泵 钉 莹 秉 汀 濒
哑	亚 呀 压 雅 牙 罚 押 涯 鸭 丫 吖 芽 讶 幺 鸦
顽	完 万 玩 晚 饭 盘 湾 弯 碗 挽 塆 丸 婉 腕 宛
爪	号 找 展 照 招 赵 召 耗 扎 兆 罩 昭 凿 肇 斋
崎	起 其 七 汽 弃 妻 旗 骑 棋 契 岂 祈 琦 凄 祁
坠	准 追 执 罪 珠 朱 徽 毁 醉 诸 绘 肢 椎 缀 蜘
淤	于 语 育 愉 郁 羽 愚 狱 愈 寓 俞 吁 钰 禺 芋
枉	网 让 望 玩 帮 王 往 忘 亡 旁 汤 仿 荡 旺 汪
蹲	论 困 损 顿 丹 盾 敦 裙 吨 芸 捆 囤 舵 笋 钧
酿	量 强 江 香 享 奖 乡 娘 详 辆 枪 祥 谅 厢 浆
懵	明 梦 嗡 盟 蒙 萌 猛 孟 蓬 僧 檬 棱 朦 烽 锰
膝	西 喜 习 吸 媳 晰 稀 溪 夕 兮 茜 犀 烯 嬉 羲
嘟	都 度 读 独 顾 舞 毒 督 杜 赌 肚 渡 堵 吨 逾
靶	吧 八 把 报 哈 拿 爸 巴 避 娃 拔 芭 罢 叭 疤
窄	海 找 值 择 债 炸 宅 芝 摘 旨 寨 肢 挚 沾 肇
株	助 祝 筑 猪 逐 珠 竹 驻 柱 煮 丶 烛 嘱 铸 诛
敖	早 案 造 奥 澳 傲 熬 凹 瑶 豹 嗷 袄 艹 蘑 懊
暨	计 级 及 集 即 急 激 吉 既 剂 寂 挤 脊 羁 藉
皂	保 早 造 搞 倒 岛 盗 遭 槽 抛 牢 糟 躁 澡 兆
幺	要 约 药 摇 邀 腰 妖 耀 遥 咬 谣 岆 瑶 姚 钥
鸦	亚 呀 压 雅 牙 罚 押 涯 鸭 丫 吖 芽 讶 哑 幺
嵌	前 钱 千 签 潜 迁 欠 牵 歉 谦 遣 铅 乾 谴 黔
骏	军 均 尊 伦 混 君 俊 允 锦 菌 逊 裙 勋 峻 抉
辐	服 复 付 父 富 府 附 符 幅 傅 伏 抚 腹 弗 缚
槛	间 见 简 检 坚 健 监 减 荐 键 渐 尖 肩 舰 奸
杏	行 性 向 星 形 型 兴 幸 醒 姓 刑 井 祥 玲 馨
沸	美 费 非 飞 肥 菲 废 纷 啡 肺 妃 匪 绯 翡 斐
剔	体 题 提 替 徒 梯 踢 漓 觅 畸 惕 蹄 涕 剃 嚏
黛	代 带 导 改 待 嘚 贷 哎 搭 戴 呆 袋 哀 栽 歹
陡	走 游 某 斗 毒 豆 尤 厚 逗 猴 兜 抖 痘 喉 剖
嗓	商 阳 往 伤 扬 绑 杭 旺 丧 纲 桑 趟 芒 沧 廊
喘	传 穿 纯 川 赚 幻 船 串 阐 沌 忏 篡 痪 搀 踹
莓	没 美 每 妹 媒 梅 菲 煤 魅 慰 眉 玫 霉 枚 昧
钮	留 牛 休 泥 羞 妮 纽 扭 浏 霓 匿 丘 妞 疚 溺
苟	候 又 够 购 构 狗 沟 奏 勾 雇 钩 釉 逅 垢 鸥
饺	教 交 较 叫 角 脚 缴 焦 胶 娇 骄 椒 矫 搅 蕉
睿	惠 退 若 弱 灰 悔 瑞 徽 毁 绘 桂 锐 龟 讳 葵
氓	帮 忙 访 央 棒 洋 钢 坊 茫 汪 盲 躺 芒 沧 妄
筛	少 师 山 睡 沙 拆 尸 驶 塞 晒 摘 屎 甩 亥 姗
嘱	助 祝 筑 猪 逐 珠 竹 驻 柱 煮 丶 烛 株 铸 诛
娟	检 坚 官 健 监 端 减 圈 卷 捐 劵 倦 眷 柬 篡
蒜	算 观 山 款 权 远 段 团 环 酸 渊 衫 杉 娟 诠
栗	理 里 力 利 立 历 离 礼 黎 莉 厘 璃 隶 哩 沥
陀	退 罗 坐 托 脱 吐 拖 扩 拓 妥 掏 吞 佐 凸 魄
蝉	产 纯 偿 昌 船 汗 叉 缠 灿 阐 禅 焊 馋 掺 铲
睹	都 度 读 独 努 顾 舞 毒 督 杜 赌 肚 渡 堵 逾
诠	全 权 券 幻 缘 酸 潜 迁 患 泉 劝 拳 悬 谦 锻
洽	钱 价 气 器 架 欠 骑 侠 恰 戚 棋 瞧 峡 邱 翘
膨	朋 峰 苹 碰 捧 鹏 彭 棚 泵 蓬 澎 乓 烹 憎 篷
腥	行 性 向 星 形 型 兴 幸 静 醒 姓 刑 馨 坪 杏
巅	点 电 店 便 典 潜 兼 诞 垫 颠 淀 殿 扂 碘 奠
瞅	后 受 售 抽 授 丑 筹 兽 瘦 臭 酬 愁 猴 舟 吼
诡	规 贵 归 鬼 柜 轨 毁 醉 跪 瑰 桂 闺 龟 硅 崔
碘	点 电 店 便 典 潜 兼 诞 垫 颠 淀 殿 扂 巅 奠
喇	马 离 拉 啦 俩 垃 辣 唻 叻 梨 蜡 腊 耙 庐 禄
冈	刚 港 访 央 棒 钢 攻 岗 杭 仰 纲 杠 旸 纺 庞
蛤	哈 互 巴 压 嘛 汉 韩 喝 岔 蝴 钠 蚂 骇 锕 耙
潍	未 维 委 味 围 威 谓 尾 慰 喂 胃 薇 魏 畏 惟
啧	字 客 课 哥 则 责 紫 液 泽 磕 冶 棵 褐 孜 仄
昊	好 海 号 药 豪 潮 貌 毫 傲 耗 浩 凹 涛 烤 嚎
噪	保 再 早 造 搞 倒 岛 盗 遭 槽 抛 牢 糟 躁 澡
稠	后 受 售 抽 授 丑 筹 兽 瘦 臭 酬 愁 猴 舟 吼
陋	友 候 又 楼 录 露 豆 陆 漏 炉 喽 庐 搂 釉 疣
幂	积 米 依 礼 密 迷 秘 蜜 弥 咪 谜 泌 靡 觅 眯
鲸	经 精 境 竟 静 竞 镜 净 敬 睛 径 晶 井 颈 殑
诀	觉 具 据 决 剧 局 句 军 绝 掘 爵 崛 抉 倔 厥
薯	数 书 术 属 述 树 舒 叔 殊 暑 鼠 署 疏 蔬 抒
亥	还 海 孩 载 牌 财 排 拍 害 择 哉 乃 摘 唻 抬
橱	出 吃 处 初 除 楚 础 触 储 撤 厨 蔬 雏 锄 诧
僧	更 冷 胜 蒙 疯 碰 森 捧 鹏 冯 讼 扔 昇 孟 耿
腌	验 严 延 炎 燕 盐 沿 岩 掩 宴 咽 衍 彦 妍 堰
崛	觉 具 据 决 剧 局 句 军 绝 掘 爵 诀 抉 倔 厥
俞	于 语 育 愉 郁 羽 愚 狱 愈 寓 吁 钰 禺 芋 煜
剁	多 盾 盗 拖 扩 洛 措 夺 朵 哆 躲 堕 妒 叨 惰
奠	点 电 店 便 典 潜 兼 诞 垫 谦 颠 淀 殿 扂 巅
茄	且 器 却 切 窃 伽 妾 怯 蔑 惬 榭 矜 沏 裘 酋
屄	比 必 笔 币 逼 避 彼 壁 碧 鄙 弊 辟 臂 蔽 庇
绊	办 帮 班 版 半 般 板 担 伴 探 坛 搬 颁 斑 扮
壕	好 海 号 药 豪 潮 貌 毫 傲 耗 浩 凹 涛 烤 嚎
硫	六 流 留 刘 漏 邻 仇 柳 浏 溜 瘤 榴 栗 琉 遛
蜗	我 播 握 佛 魔 末 卧 窝 沃 陌 脉 涡 伍 喔 勿
髓	队 随 斯 适 岁 虽 碎 屎 遂 圭 窥 嘶 矢 隧 穗
墅	数 书 术 属 述 树 舒 叔 殊 暑 鼠 署 疏 蔬 抒
唠	老 报 造 络 跑 劳 赖 矛 牢 捞 姥 佬 拦 袍 烙
舱	让 场 从 藏 羊 仓 荡 邦 郎 苍 灿 趟 芒 沧 蚕
哺	不 部 步 补 布 苦 播 负 捕 污 谱 怖 卜 埠 簿
悍	航 汉 韩 含 寒 涵 喊 汗 憾 函 俺 撼 旱 晗 焊
桩	专 转 装 张 状 涨 皇 庄 妆 撞 壮 砖 凰 谎 慌
钞	号 找 超 差 朝 潮 烧 赵 炒 吵 耗 浩 抄 缠 嘲
扛	让 帮 养 康 榜 洋 钢 抗 朗 绑 孔 氧 烫 缸 冈
蚁	艺 依 异 遗 亦 姨 翼 乙 抑 逸 疫 毅 溢 蛾 弈
蔓	满 谈 范 慢 漫 贸 蛮 曼 番 埋 迈 滥 婉 瞒 馒
撮	作 做 错 座 左 坐 租 索 昨 措 桌 遭 惑 夺 阻
轿	教 交 较 叫 角 脚 缴 焦 胶 娇 骄 椒 矫 搅 蕉
桔	接 节 界 姐 借 阶 杰 截 揭 捷 戒 皆 劫 竭 芥
侨	巧 桥 胶 乔 敲 悄 瞧 雀 翘 俏 掐 窍 虔 筱 哮
咕	股 故 古 顾 估 鼓 骨 孤 姑 谷 雇 辜 菇 沽 箍
腕	完 万 玩 晚 范 湾 弯 碗 挽 塆 丸 妄 滥 婉 顽
氮	但 单 担 严 翻 暗 蛋 淡 丹 旦 胆 诞 耽 郸 惮
酶	没 美 每 委 妹 卫 媒 梅 菲 煤 魅 碑 眉 玫 霉
艇	听 清 景 挺 停 庭 厅 订 兵 迎 堂 径 颖 婷 亭
帘	联 连 千 简 练 恋 脸 链 炼 怜 莲 廉 谦 敛 斓
朔	所 活 术 顺 熟 树 舒 缩 硕 惑 稍 暑 霍 蔬 蜀
疚	就 九 究 酒 久 救 旧 纠 舅 揪 玖 韭 灸 钮 鹫
掂	点 电 店 便 典 潜 诞 垫 谦 锻 颠 淀 殿 扂 巅
焗	车 具 据 剧 局 居 巨 聚 距 拒 拘 矩 菊 橘 狙
蜀	数 书 术 属 述 树 舒 叔 殊 暑 署 疏 蔬 抒 赎
裔	艺 依 异 遗 亦 姨 翼 乙 抑 逸 疫 毅 溢 弈 祎
溺	你 尼 吉 拟 紫 泥 逆 妮 埃 欸 腻 伱 倪 霓 匿
蛙	妈 它 达 马 吴 娃 挖 哇 瓦 鸭 叭 雾 爬 喔 袜
凿	保 早 造 搞 倒 岛 盗 遭 槽 抛 牢 糟 躁 澡 兆
邱	求 球 休 秋 齐 仇 溜 丘 玖 伽 囚 妾 糗 擒 裘
兮	西 喜 习 吸 媳 晰 稀 溪 夕 茜 犀 烯 熄 嬉 羲
鳎	跌 邪 谐 裂 爹 蟹 携 皆 猎 泄 蒂 蝎 劣 歇 劫
橡	想 相 像 向 象 项 响 香 享 乡 箱 详 翔 祥 湘
吁	于 语 育 愉 郁 羽 愚 狱 愈 寓 俞 钰 禺 芋 煜
绷	等 并 冷 封 蒙 疯 邦 横 崩 蚌 丙 澄 蹦 泵 蹭
趴	妈 它 达 马 怕 跑 牙 扒 鸭 叭 爬 啪 葩 帕 噗
殷	因 音 银 引 尽 印 阴 隐 饮 姻 淫 瘾 吟 尹 茵
嚣	小 笑 消 销 效 晓 胶 孝 咁 肖 萧 削 宵 潇 霄
凳	当 等 登 灯 仍 邓 崩 彭 橙 澄 蹭 盯 耿 懵 瞪
渺	销 描 貌 妙 秒 苗 喵 庙 矫 飙 彪 俏 婊 廖 刁
沂	艺 依 遗 亦 姨 翼 乙 抑 逸 疫 毅 溢 奕 弈 祎
菩	普 批 突 铺 谱 腐 扑 浦 葡 芦 凸 醋 穆 畜 埔
熏	军 训 询 寻 讯 迅 循 遵 巡 逊 旬 勋 钝 驯 薰
窑	要 约 脑 药 摇 邀 腰 妖 耀 遥 咬 谣 岆 瑶 姚
嗦	所 错 苏 索 锁 缩 洛 措 惑 夺 扫 霍 琐 嫂 琢
靴	学 解 续 血 询 雪 阅 鞋 讯 巡 泄 叙 岳 蝎 歇
肇	号 找 展 照 招 赵 召 耗 扎 诈 兆 罩 昭 爪 凿
尧	要 约 脑 药 摇 邀 腰 妖 耀 遥 咬 谣 岆 瑶 丫
彤	同 通 统 痛 童 铜 筒 桶 桐 瞳 耸 珑 捅 佟 踊
揉	友 候 入 楼 油 购 欧 肉 悠 柔 凑 猴 兜 酉 喉
茜	西 喜 习 吸 媳 晰 稀 溪 夕 兮 犀 烯 熄 嬉 羲
脊	计 级 及 技 集 即 积 急 激 继 吉 辑 既 剂 挤
缚	服 复 付 父 富 府 附 妇 符 幅 肤 傅 抚 腹 弗
郝	好 海 号 药 豪 潮 貌 毫 傲 耗 浩 凹 涛 烤 嚎
贿	会 回 惠 汇 挥 慧 悔 徽 毁 绘 恢 讳 晦 荟 秽
埔	普 批 突 铺 谱 腐 扑 浦 葡 芦 凸 醋 穆 畜 菩
哩	理 里 力 利 立 历 离 礼 黎 莉 厘 璃 隶 栗 沥
鲍	保 报 办 包 宝 抱 爆 暴 薄 饱 堡 剥 胞 曝 豹
锈	续 戏 修 秀 休 羞 袖 揪 绣 斜 瘤 玖 畜 絮 朽
碱	间 见 简 检 坚 健 监 减 荐 键 渐 尖 肩 舰 奸
壹	艺 依 亦 姨 翼 乙 抑 逸 疫 毅 溢 奕 弈 祎 沂
祷	到 道 导 倒 岛 刀 澳 旦 冒 傲 戴 胆 盗 呆 邀
乒	平 请 并 评 病 硬 竞 聘 凭 瓶 苹 径 凌 钉 荆
溯	诉 速 素 舞 苏 宿 俗 塑 傅 肃 凸 醋 妒 吾 舆
泌	米 密 迷 秘 蜜 姨 弥 咪 谜 幂 靡 觅 蚂 凄 眯
闽	民 命 敏 蛮 邻 淫 旻 闵 悯 冕 谩 矜 泯 腼 皿
醇	处 存 春 顺 纯 船 寸 串 蠢 唇 禅 馋 喘 蝉 淳
揽	反 兰 判 蓝 览 烂 懒 篮 栏 沿 函 盼 滥 拌 拦
彪	表 交 报 标 叫 效 料 挑 缴 漂 晓 胞 屌 飙 婊
敛	联 连 简 练 恋 脸 链 炼 怜 莲 廉 辽 帘 斓 柬
氢	情 请 清 亲 青 轻 庆 硬 倾 晴 盯 荆 卿 擎 邢
筝	正 证 政 整 争 涨 征 震 郑 症 忠 挣 肿 蒸 绳
遂	队 随 适 岁 虽 碎 屎 髓 圭 窥 嘶 矢 隧 穗 隋
崖	妈 亚 呀 压 雅 牙 押 涯 鸭 逸 丫 吖 芽 讶 哑
谍	跌 邪 谐 裂 爹 蟹 携 皆 猎 泄 蒂 蝎 劣 歇 劫
阜	服 复 付 父 富 府 附 妇 符 幅 傅 抚 腹 弗 辐
憨	汉 韩 含 寒 涵 喊 汗 憾 函 俺 弯 撼 氨 旱 晗
瞪	当 等 登 灯 仍 碰 邓 崩 彭 橙 澄 蹭 盯 耿 懵
咩	别 密 列 届 灭 爹 蟹 蝶 鳎 眯 芥 撇 谬 怯 蔑
乞	七 汽 妻 旗 骑 棋 契 歧 琪 岂 祈 琦 凄 绮 砌
仕	十 事 什 实 市 师 使 失 适 石 势 室 释 湿 饰
帧	镇 针 珍 圳 震 阵 诊 振 侦 贞 甄 枕 疹 臻 朕
翘	巧 桥 胶 乔 敲 悄 瞧 雀 侨 俏 掐 窍 虔 筱 哮
侮	五 物 午 武 舞 吴 悟 乌 伍 呜 吾 巫 唔 坞 梧
竖	数 书 术 属 述 树 舒 叔 殊 暑 署 疏 蔬 抒 赎
敞	场 常 唱 章 航 厂 冲 偿 昌 尝 崇 畅 肠 倡 阐
嚼	交 较 叫 角 脚 缴 焦 胶 娇 骄 椒 矫 搅 蕉 浇
靡	米 密 迷 秘 蜜 弥 咪 谜 幂 泌 觅 眯 糜 芈 肄
壤	让 房 望 防 党 仿 荡 邦 杭 仰 杠 肪 镑 琅 乓
毙	比 笔 币 逼 避 鼻 彼 壁 碧 鄙 弊 辟 臂 蔽 屄
媛	原 院 元 远 愿 园 缘 圆 怨 援 袁 苑 冤 渊 猿
隙	西 喜 习 吸 媳 晰 稀 溪 夕 兮 茜 犀 烯 熄 嬉
锌	心 新 信 形 您 欣 辛 拼 薪 芯 鑫 腺 吟 彬 膝
玺	西 喜 习 吸 媳 晰 稀 溪 夕 兮 茜 犀 烯 熄 嬉
毯	谈 慢 弹 探 坛 坦 摊 贪 叹 碳 滩 炭 烫 吞 谭
噩	哦 额 恶 呃 饿 鹅 厄 鄂 遏 娥 讹 扼 胺 峨 鳄
橘	车 具 据 剧 局 居 巨 聚 距 拒 惧 拘 矩 菊 狙
揣	穿 怀 坏 川 船 吹 拆 串 衰 柴 垂 摔 甩 淮 锤
澈	河 陈 扯 彻 撤 吓 尘 尺 厨 矗 嗤 蔗 褚 忱 琛
暧	爱 细 哎 艾 疾 唉 碍 埃 欸 挨 哀 癌 凹 矮 漓
邵	少 超 绍 朝 烧 硕 炒 稍 闪 召 吵 兆 擅 珊 汕
屯	团 谈 孙 迅 徒 俊 叹 循 菌 韵 吞 陀 毯 臀 褪
咀	最 惠 追 左 退 族 执 止 织 租 汇 罪 嘴 醉 卉
沥	理 里 力 利 立 历 离 礼 黎 莉 厘 璃 隶 栗 哩
垒	内 位 类 备 历 累 雷 泪 勒 赖 玫 黎 蕾 磊 沸
酵	交 较 叫 角 脚 缴 焦 胶 娇 骄 椒 矫 搅 蕉 浇
湛	展 照 山 站 战 占 闪 炸 丈 粘 颤 詹 沾 斩 爪
厄	哦 额 恶 呃 饿 鹅 噩 鄂 遏 娥 讹 扼 胺 峨 鳄
滇	点 电 店 便 典 潜 诞 垫 谦 锻 颠 淀 殿 扂 巅
雍	用 从 永 拥 勇 洋 庸 泳 涌 佣 樱 咏 秧 甬 踊
暮	目 母 顾 舞 鱼 木 幕 慕 姆 牧 墓 募 瑜 穆 畜
岔	差 楚 察 沙 触 茶 插 储 扎 莎 叉 侈 蝉 榨 茬
铸	主 住 助 祝 筑 猪 逐 珠 竹 驻 柱 煮 丶 烛 株
饲	四 司 思 死 斯 食 礼 素 似 丝 私 撕 寺 肆 嘶
抠	友 候 口 构 某 苦 扣 幼 奏 呦 吼 枯 逅 嗽 艘
邢	行 性 星 形 型 兴 幸 醒 详 姓 刑 祥 馨 杏 腥
淇	七 汽 妻 旗 骑 棋 歧 琪 岂 祈 乞 琦 凄 绮 砌
搓	活 错 措 惑 夺 挫 裹 翠 豁 醋 嗦 蓑 磋 厝 捋
愣	更 另 冷 令 丰 疼 锋 哼 凌 奉 郎 陵 猛 蜂 梗
粪	分 非 任 份 温 粉 肥 奋 纷 氛 愤 芬 盆 雯 坟
苛	可 科 客 课 克 刻 隔 颗 渴 壳 柯 磕 棵 坷 珂
肪	方 放 房 养 阳 往 防 访 仿 芳 脏 挡 坊 妨 逢
苞	保 报 办 包 宝 讨 抱 爆 暴 薄 饱 堡 剥 胞 曝
聆	零 领 另 灵 令 龄 凌 玲 铃 陵 岭 菱 伶 拎 羚
掺	产 纯 偿 昌 船 汗 叉 缠 灿 阐 禅 焊 馋 蝉 铲
逮	代 带 导 待 嘚 贷 哎 搭 戴 呆 袋 哀 栽 歹 黛
亨	政 风 朋 腾 乘 蒙 郑 疯 衡 恒 横 哼 彭 牲 惩
霄	小 笑 消 销 效 晓 孝 辽 屌 肖 萧 削 宵 潇 嚣
麟	林 尽 临 邻 琳 淋 赁 澜 菱 榴 吟 彬 霖 吝 磷
狙	车 具 据 剧 局 居 巨 聚 距 拒 惧 拘 矩 菊 橘
孜	自 子 资 字 咨 仔 紫 姿 滋 兹 籽 淄 梓 疵 呲
镑	帮 榜 访 央 棒 邦 绑 仰 苍 丧 纲 膀 缸 柄 冈
曦	西 喜 习 吸 媳 晰 溪 夕 兮 茜 玺 犀 烯 熄 嬉
癫	点 电 店 便 典 潜 诞 垫 谦 锻 颠 淀 殿 扂 巅
惰	多 盾 盗 拖 扩 洛 措 夺 朵 哆 躲 堕 妒 叨 剁
牡	目 母 顾 族 麻 鱼 木 幕 慕 姆 牧 墓 募 敷 瑜
沐	目 母 顾 族 麻 鱼 木 幕 慕 姆 牧 墓 募 敷 瑜
黏	年 店 便 显 念 贤 垫 眠 肩 歉 莲 廉 辨 谦 舰
甭	等 并 冷 封 蒙 疯 横 崩 蚌 丙 澄 蹦 泵 蹭 绷
缔	地 第 低 底 弟 递 帝 滴 迪 抵 敌 蒂 堤 笛 旳
缅	面 见 联 线 免 健 潜 敏 兼 迁 践 眠 棉 淀 箭
铲	产 纯 偿 昌 船 汗 叉 缠 灿 阐 禅 焊 馋 蝉 掺
缆	反 范 兰 判 蓝 览 烂 懒 篮 栏 沿 函 盼 滥 拦
汕	深 山 善 删 闪 汗 厦 扇 陕 擅 衫 珊 杉 姗 煽
蝴	户 护 互 乎 湖 呼 胡 虎 糊 狐 沪 壶 葫 弧 唬
钠	那 哪 拿 码 亚 怕 纳 罚 娜 涯 哒 呐 啪 匿 噶
枢	书 术 属 述 输 束 树 舒 叔 殊 暑 鼠 署 疏 抒
殇	上 长 商 省 伤 厂 尚 赏 畅 昇 绳 甸 衫 敞 裳
摧	队 退 瑞 吹 腿 磁 催 脆 粹 龟 翠 崔 贿 萃 荟
犀	西 喜 习 吸 媳 晰 溪 夕 兮 茜 玺 曦 烯 熄 嬉
窦	头 走 游 某 邮 斗 豆 尤 厚 逗 猴 兜 抖 痘 喉
烘	重 红 航 控 宏 浓 洪 虹 铜 踪 鸿 讼 轰 哄 弘
歼	间 见 简 检 坚 健 监 减 荐 键 渐 尖 肩 舰 奸
揍	走 由 周 楼 优 住 投 油 奏 竹 诱 猴 兜 驻 抖
璐	路 录 绿 鲁 鹿 炉 卢 碌 撸 芦 卤 庐 禄 噜 泸
妓	计 级 及 集 即 积 急 激 纪 鸡 吉 剂 肌 挤 忌
俏	巧 桥 欠 胶 乔 敲 悄 瞧 雀 侨 翘 掐 窍 钳 哮
坷	可 科 客 课 克 刻 隔 颗 渴 壳 柯 枯 磕 棵 苛
诛	住 助 祝 筑 猪 逐 珠 竹 驻 柱 丶 烛 嘱 铸 蛛
拙	住 追 著 桌 卓 捉 丶 豁 佐 灼 浊 辍 酌 镯 嚯
焰	验 严 延 炎 燕 盐 沿 掩 宴 咽 衍 彦 妍 腌 堰
哨	少 超 绍 朝 烧 硕 炒 稍 闪 召 吵 兆 擅 珊 邵
漓	理 里 力 利 立 历 离 礼 黎 莉 厘 璃 隶 栗 哩
蛛	住 助 祝 筑 猪 逐 珠 竹 驻 柱 丶 烛 嘱 铸 诛
绽	展 张 照 查 站 战 占 丈 粘 颤 詹 沾 斩 窄 憨
淹	验 严 延 炎 燕 盐 沿 掩 宴 咽 衍 彦 妍 腌 堰
瘫	谈 慢 弹 探 坛 坦 摊 贪 叹 碳 滩 炭 烫 谭 潭
渤	保 博 播 波 伯 拨 玻 颇 勃 搏 泊 驳 脖 褒 舶
觅	极 米 密 迷 秘 蜜 弥 咪 谜 栗 幂 泌 靡 眯 糜
噎	也 业 夜 爷 野 页 叶 液 泽 耶 曰 椰 冶 讹 烨
瘪	别 毕 笔 憋 鳖 聂 膊 邂 痹 缤 陛 榭 殡 偕 秸
畴	后 受 售 础 抽 授 丑 筹 兽 瘦 臭 酬 愁 舟 吼
犁	理 里 力 利 立 历 离 礼 黎 莉 厘 璃 隶 栗 哩
祛	去 区 取 句 曲 趣 趋 驱 屈 渠 叙 愈 娶 躯 佢
蛆	去 区 取 句 曲 趣 趋 驱 屈 渠 叙 愈 娶 躯 佢
拽	专 转 传 追 怀 坏 赚 宅 砖 衰 摔 寨 甩 淮 揣
卤	路 录 绿 鲁 鹿 炉 卢 碌 撸 芦 璐 庐 禄 噜 泸
蚂	吗 妈 马 码 亚 怕 米 嘛 麻 猫 骂 玛 涯 祂 啪
憬	经 精 京 境 景 竞 镜 净 敬 睛 径 晶 井 颈 殑
羁	计 级 及 集 即 积 急 激 纪 鸡 吉 剂 肌 挤 忌
霖	李 林 尽 临 邻 琳 淋 赁 澜 菱 榴 吟 彬 麟 吝
憧	成 从 充 承 厂 冲 盛 聪 崇 虫 宠 呈 洪 衷 葱
栈	展 张 照 查 站 战 占 丈 粘 颤 詹 沾 斩 窄 憨
茎	经 精 京 境 景 竞 镜 净 敬 睛 径 晶 井 颈 殑
俭	间 见 简 检 坚 健 监 减 荐 键 渐 尖 肩 舰 奸
纬	味 围 卫 威 谓 违 慰 胃 薇 畏 巍 惟 猥 萎 玮
琦	七 汽 妻 旗 骑 棋 契 歧 琪 岂 祈 乞 凄 绮 砌
雁	验 严 延 炎 燕 盐 沿 掩 宴 咽 衍 彦 妍 腌 堰
凄	七 汽 妻 旗 骑 棋 契 歧 琪 岂 祈 乞 琦 绮 砌
袍	跑 闹 贸 泡 浩 妖 炮 陶 抛 牢 涛 烤 叛 嫂 燥
赣	感 万 干 敢 赶 残 甘 盐 杆 肝 尴 焊 镐 棺 樊
雏	出 吃 处 初 除 楚 础 触 储 厨 蔬 丶 橱 锄 诧
讳	会 回 汇 挥 慧 悔 徽 毁 恢 贿 卉 晖 晦 荟 秽
焚	分 非 任 反 份 粉 肥 奋 纷 氛 愤 芬 盆 雯 坟
瞳	同 通 统 痛 童 综 铜 筒 桶 躺 桐 彤 耸 珑 捅
恍	欢 黄 床 皇 壮 荒 凰 谎 慌 煌 晃 疮 幢 惶 簧
骇	还 海 孩 载 牌 财 黑 排 拍 害 择 乃 摘 唻 抬
孵	服 福 父 负 富 符 肤 辅 傅 伏 覆 弗 敷 芙 辐
钦	青 引 切 仅 琴 勤 侵 秦 寝 泣 栖 倩 吟 彬 崎
淳	处 存 春 顺 纯 船 寸 串 蠢 唇 禅 馋 喘 蝉 醇
葵	跨 亏 轨 馈 愧 溃 窥 盔 魁 奎 匮 撅 傀 绔 睽
礁	交 校 较 叫 角 脚 缴 胶 娇 骄 椒 矫 搅 蕉 浇
殴	族 鱼 木 苏 湖 估 欧 偶 喽 酉 瑜 喉 芦 呕 鸥
仑	论 轮 损 伦 混 逻 允 逊 裙 旬 拦 沦 芸 禄 捆
侄	之 只 直 制 质 智 止 织 纸 址 枝 旨 滞 蜘 酯
鳖	别 谢 写 界 协 贴 揭 械 捷 灭 泄 憋 斌 窃 斜
禽	银 青 频 琴 勤 侵 秦 淫 寝 茄 钦 沁 糗 旻 芹
焕	欢 婚 源 换 环 惯 幻 患 缓 唤 喘 憨 媛 桓 痪
梵	反 言 饭 范 翻 烦 犯 访 凡 繁 返 泛 番 帆 贩
挠	男 宝 脑 豪 诺 闹 糕 妖 炮 桃 槽 耀 饱 恼 捞
灶	早 造 杂 草 爆 昨 遭 稿 槽 糟 躁 澡 膏 燥 枣
咚	动 东 空 懂 登 顶 灯 勇 冬 宗 洞 聪 董 纵 冻
闸	找 查 债 珠 哲 咋 扎 炸 渣 诈 罩 榨 眨 乍 栅
伺	次 此 词 急 笔 益 依 礼 击 材 刺 辞 磁 慈 瓷
烊	样 眼 养 阳 杨 央 洋 扬 羊 仰 氧 旸 痒 秧 漾
茹	如 入 故 诉 付 遇 孤 宇 虎 予 乳 狱 腹 雾 辱
邹	走 由 周 楼 优 住 投 油 奏 竹 诱 猴 兜 驻 抖
盅	中 种 重 证 整 充 红 终 众 钟 涨 忠 宠 虹 仲
仆	普 批 突 铺 谱 腐 扑 浦 葡 芦 凸 醋 穆 畜 菩
韬	早 套 讨 淘 邀 逃 稿 桃 陶 涛 捣 萄 掏 苞 滔
懦	做 果 左 若 伙 诺 锁 拖 洛 措 裹 螺 佐 挪 跺
唧	己 计 级 及 集 即 积 急 激 鸡 吉 剂 挤 忌 祭
蒲	普 武 举 土 铺 谱 扑 浦 葡 凸 醋 妒 菩 埔 仆
葫	户 护 乎 湖 呼 胡 虎 忽 糊 狐 沪 壶 蝴 弧 唬
畸	己 计 级 及 集 即 积 急 激 鸡 吉 剂 挤 忌 祭
噗	普 武 举 土 铺 谱 扑 浦 葡 凸 醋 妒 菩 埔 仆
尹	因 音 银 引 印 阴 隐 饮 姻 抑 淫 瘾 吟 殷 茵
垮	话 化 快 困 咯 跨 滑 亏 扩 瓜 裤 夸 阔 哗 葵
褒	保 报 包 宝 抱 爆 暴 薄 邀 逃 饱 堡 恼 剥 胞
峻	军 均 尊 伦 混 君 俊 允 菌 逊 裙 勋 倦 骏 抉
掠	旅 列 略 虑 裂 侣 猎 劣 叻 虐 吕 滤 驴 疟 咧
掐	钱 价 器 架 欠 骑 恰 戚 棋 瞧 峡 寝 洽 邱 翘
昕	心 新 信 希 惜 欣 辛 薪 馨 巡 羡 夕 芯 鑫 锌
硝	小 笑 消 销 效 晓 孝 肖 萧 削 宵 潇 侨 嚣 霄
汀	听 星 英 统 亲 领 形 挺 停 庭 厅 映 疼 婷 亭
傍	帮 朋 刚 王 港 糖 旁 汤 胖 仿 庞 萍 葬 廊 拌
嫣	验 严 延 炎 燕 盐 沿 掩 宴 咽 衍 彦 妍 腌 堰
绅	身 神 深 称 申 审 甚 沈 伸 慎 肾 渗 汕 婶 赡
褶	这 着 者 致 折 喆 哲 浙 遮 煮 吱 辙 辄 蔗 啫
芜	五 务 物 武 舞 乌 伍 勿 吾 坞 侮 梧 捂 毋 钨
锕	啊 阿 按 码 亚 怕 爸 呀 额 巴 压 芽 讶 哑 靶
窍	巧 桥 乔 敲 喵 悄 瞧 雀 侨 翘 俏 掐 撬 跷 峭
耙	普 亚 怕 扒 浦 爬 砸 泼 祂 啪 葩 帕 哑 靶 鸦
狄	地 第 低 底 弟 递 帝 滴 迪 抵 敌 蒂 堤 笛 旳
椎	水 制 择 致 追 嘴 灰 朱 徽 毁 竹 枝 捉 坠 缀
皓	好 海 号 药 豪 潮 貌 毫 傲 耗 浩 凹 涛 烤 嚎
卉	会 回 惠 汇 慧 悔 辉 徽 毁 绘 恢 贿 讳 晖 晦
桓	欢 婚 源 换 环 惯 幻 患 缓 唤 喘 憨 媛 焕 痪
嵩	红 共 送 供 融 松 宋 讼 轰 诵 颂 雍 怂 耸 悚
啃	任 客 根 肯 恩 困 稳 忍 仁 壳 昆 愤 吻 坎 雯
呕	族 鱼 木 苏 湖 估 欧 偶 喽 酉 瑜 喉 芦 殴 鸥
棺	关 管 原 观 官 软 馆 惯 冠 贯 灌 莞 罐 纶 竿
佰	百 白 般 毕 载 牌 财 板 拍 害 拜 败 摆 柏 狸
颐	艺 依 异 亦 姨 翼 乙 抑 逸 疫 毅 溢 奕 弈 祎
樊	反 言 饭 范 翻 烦 犯 访 凡 繁 返 泛 番 帆 贩
藉	计 级 及 集 即 积 急 激 继 鸡 吉 剂 肌 挤 忌
沛	北 非 配 培 谓 陪 赔 佩 韦 匹 披 枚 磊 畏 贼
馅	现 限 险 显 县 鲜 闲 仙 陷 嫌 贤 羡 咁 纤 弦
烁	活 获 熟 述 缩 硕 祸 琐 朔 蜀 嗦 灬 蓑 浊 辍
煞	哈 视 设 势 啥 杀 沙 傻 涉 狮 烧 厦 纱 莎 蚀
濒	音 近 边 遍 避 欣 宾 碧 滨 饼 辨 谨 斌 彬 尹
谴	前 钱 千 签 潜 迁 牵 歉 谦 遣 铅 乾 倩 嵌 黔
糙	操 草 贸 潮 貌 毫 堡 蹈 曹 曝 瑶 茂 敖 袍 挠
鄂	哦 恶 俄 呃 饿 噩 厄 遏 娥 讹 扼 胺 峨 鳄 愕
惕	体 题 提 替 徒 剂 梯 踢 剔 漓 伺 唧 蹄 涕 剃
韶	少 号 找 杀 绍 烧 稍 闪 召 吵 耗 纱 嫂 衫 邵
暇	下 西 喜 消 限 夏 俩 侠 瞎 霞 萧 虾 辖 峡 狭
劈	批 皮 屁 脾 疲 匹 披 啤 癖 痞 坯 霹 琵 媲 丕
绯	费 非 飞 肥 菲 废 啡 肺 霉 畏 妃 匪 沸 翡 斐
啸	小 笑 消 销 效 漂 晓 孝 肖 萧 削 宵 潇 衔 嚣
泻	些 解 谢 写 协 鞋 械 邪 谐 蟹 携 泄 蝎 歇 卸
籽	自 子 资 字 咨 仔 紫 姿 滋 兹 孜 淄 梓 疵 呲
拷	考 早 造 靠 淘 烤 骚 阔 躁 澡 砍 坎 岆 瑶 曜
旷	光 况 狂 宽 矿 逛 荒 框 凰 慌 煌 扛 恍 匡 眶
拢	龙 宫 聪 隆 鸿 葱 笼 诵 溶 垄 珑 聋 胧 陇 咙
淄	自 子 资 字 咨 仔 紫 姿 滋 兹 孜 籽 梓 疵 呲
瑕	下 喜 价 夏 嘉 席 侠 瞎 霞 萧 虾 辖 峡 狭 暇
澎	朋 峰 苹 碰 捧 鹏 彭 棚 泵 蓬 膨 乓 烹 憎 篷
庐	路 录 绿 鲁 鹿 炉 卢 碌 撸 芦 璐 卤 禄 噜 泸
嘞	类 累 陪 雷 泪 勒 蕾 磊 贼 妃 诶 嗨 蔚 昧 隶
稣	诉 速 素 舞 苏 宿 俗 塑 傅 肃 凸 醋 妒 吾 舆
猥	微 未 味 围 卫 威 谓 唯 伟 薇 魏 韦 畏 蔚 巍
萎	微 未 味 围 卫 威 谓 唯 伟 薇 魏 韦 畏 蔚 巍
掰	百 白 毕 载 排 板 拍 害 拜 败 摆 柏 狸 汰 扳
恤	需 许 续 须 序 虚 绪 徐 蓄 叙 旭 畜 絮 婿 墟
玮	微 未 味 围 卫 威 谓 唯 伟 薇 魏 韦 畏 蔚 巍
汾	分 费 认 份 粉 恩 奋 菲 纷 笨 氛 奉 愤 芬 恳
囚	求 球 休 秋 齐 仇 歧 溜 丘 玖 伽 崎 邱 糗 咻
琅	放 龙 浪 洋 钢 朗 昂 隆 粮 狼 芳 郎 痒 沧 廊
萱	选 宣 旋 悬 暅 炫 玄 轩 喧 渲 绚 璇 嬛 眩 漩
瞻	展 站 战 占 珍 粘 胀 撼 兆 擅 衫 颤 詹 沾 斩
孽	些 接 写 届 杰 妮 蟹 霓 叠 捏 讷 迭 聂 涅 拗
怂	红 共 送 供 永 松 聪 宋 鸿 讼 轰 诵 颂 雍 嵩
鞠	车 具 据 剧 句 居 巨 聚 距 拒 拘 矩 菊 焗 橘
芸	员 运 言 云 孕 允 晕 韵 蕴 匀 熏 酝 耘 陨 昀
勺	少 号 找 杀 绍 烧 稍 闪 召 吵 耗 纱 嫂 衫 邵
喧	选 宣 旋 悬 暅 炫 玄 轩 萱 渲 绚 璇 嬛 眩 漩
俯	服 福 父 富 符 肤 辅 傅 覆 弗 敷 芙 辐 缚 阜
镀	都 度 读 独 顾 毒 督 杜 赌 肚 渡 堵 吨 妒 嘟
冀	计 级 及 集 即 急 激 吉 既 剂 寂 挤 脊 羁 畸
讷	呢 喝 革 纳 恶 侧 尼 爷 厕 野 嚒 页 叶 拟 荷
乓	帮 朋 刚 王 港 糖 旁 汤 胖 仿 庞 萍 葬 廊 拌
咔	哈 科 卡 亚 怕 苦 咯 咖 渴 壳 涯 腊 砸 啪 哑
抉	月 觉 决 绝 距 掘 爵 诀 崛 倔 隽 厥 獗 莒 珏
喃	男 难 南 干 演 满 版 晚 弹 暖 湾 沿 函 杆 堪
惫	费 北 备 背 卫 悲 贝 违 辈 杯 倍 呗 碑 卑 薇
粑	吧 八 把 卡 爸 呀 播 巴 薄 拔 芭 罢 怖 叭 啪
棕	总 容 弄 综 荣 勇 攻 宗 纵 踪 佣 匆 栋 丛 蓉
婶	身 神 深 称 申 审 甚 沈 伸 慎 肾 渗 汕 绅 赡
禄	录 陆 绿 鲁 鹿 炉 卢 撸 芦 璐 卤 庐 噜 泸 虏
苔	太 白 台 态 哎 泰 胎 桃 陶 挨 哀 摊 抬 汰 毯
眯	极 米 密 迷 秘 蜜 眉 弥 咪 谜 栗 幂 泌 靡 觅
丐	外 买 太 百 该 改 待 卖 概 盖 柏 袋 哉 闺 尴
荔	理 里 力 利 立 历 离 黎 莉 厘 璃 隶 栗 哩 沥
芥	接 结 界 姐 介 街 借 截 揭 捷 戒 皆 劫 羯 桔
寥	校 叫 效 料 聊 疗 缴 辽 搅 撩 婊 廖 刁 僚 镰
缀	水 制 择 致 追 嘴 灰 朱 徽 毁 竹 枝 捉 坠 椎
楷	开 待 卖 态 载 牌 财 排 拍 害 嘅 凯 慨 勘 狸
睦	目 母 顾 族 麻 鱼 木 幕 慕 姆 牧 墓 募 敷 瑜
柠	清 星 精 宁 苹 倾 赢 刑 凝 卿 菱 擎 璟 腥 鲸
搂	又 头 楼 录 露 豆 陆 偶 搜 透 漏 炉 喽 陋 庐
熔	让 容 供 控 融 荣 孔 扔 蓉 绒 溶 弓 榕 冗 茸
捆	困 尊 损 亏 魂 扩 夸 昆 逊 砍 裙 坤 吨 棍 窥
驹	车 具 据 剧 句 居 巨 聚 距 拒 拘 矩 菊 焗 橘
梧	五 务 物 午 武 舞 悟 伍 勿 唔 坞 侮 捂 毋 钨
圭	规 贵 归 挂 鬼 柜 轨 跪 瑰 桂 闺 龟 硅 诡 咕
汝	如 入 故 诉 遇 孤 虎 予 乳 腹 雾 狐 辱 儒 嘟
窥	快 随 鬼 嘴 亏 阔 馈 愧 溃 葵 盔 魁 奎 匮 傀
吏	理 里 力 利 立 历 离 黎 莉 厘 璃 隶 栗 哩 沥
秃	图 股 步 土 突 途 偷 玉 俗 祖 吐 徒 兔 涂 赋
恬	天 团 限 简 田 填 甜 添 舔 帘 掂 碱 敛 癫 黏
倚	依 异 亦 姨 翼 乙 抑 逸 疫 毅 溢 奕 弈 祎 沂
檬	等 名 梦 腾 盟 蒙 疯 萌 猛 冯 孟 泵 蹭 懵 绷
舶	包 博 播 波 伯 拨 脉 玻 勃 搏 泊 驳 脖 屄 蜗
嫖	交 校 票 疗 骗 漂 秒 朴 飘 浇 刁 僚 瞄 瓢 淼
碾	年 钱 件 便 念 健 签 艰 贱 棉 楠 癫 黏 惦 蔫
婊	表 标 条 笑 消 销 票 胞 朴 钓 飙 彪 镖 筱 撬
撇	品 解 被 接 且 铁 街 截 裂 爹 匹 披 蝶 伽 懈
姗	山 善 顺 占 删 闪 扇 陕 擅 衫 珊 杉 汕 煽 讪
遏	哦 额 恶 俄 呃 鹅 噩 厄 鄂 娥 讹 扼 胺 峨 鳄
廖	校 叫 效 料 聊 疗 缴 辽 搅 撩 寥 嫖 婊 刁 僚
疮	装 创 川 床 妆 窗 畅 肠 谎 闯 煌 晃 恍 幢 簧
幢	转 装 状 赚 床 庄 妆 窗 爽 撞 壮 荒 砖 胀 霜
朽	西 喜 求 究 修 秀 休 嘻 丢 绪 羞 歇 熙 卸 袖
囤	蛋 讯 顿 迅 盾 遵 锻 巡 敦 堕 耽 坤 吨 妒 蹲
牟	由 模 否 某 幕 厚 摩 沟 莫 膜 谋 喽 酉 喉 眸
嘶	四 司 思 死 斯 食 素 击 似 丝 私 撕 寺 肆 饲
矢	什 实 师 试 世 视 式 使 失 识 示 士 适 饰 狮
疹	真 镇 针 珍 圳 震 阵 诊 振 侦 贞 甄 枕 帧 臻
荧	应 影 英 硬 映 赢 盈 颖 鹰 樱 莹 蝇 萤 莺 嘤
睐	来 海 利 孩 奶 累 兰 灾 泪 勒 赖 莱 挨 唻 嘞
岚	般 兰 蓝 览 烂 懒 篮 栏 唻 肝 琳 滥 拦 澜 揽
榄	般 兰 蓝 览 烂 懒 篮 栏 唻 肝 琳 滥 拦 澜 揽
茵	因 音 银 引 印 阴 隐 饮 姻 乙 淫 瘾 吟 殷 尹
谬	救 休 旧 羞 慕 姆 谋 仇 袖 榴 灸 亩 钮 幂 硫
刁	交 笑 销 料 掉 吊 屌 雕 肖 萧 钓 酵 滇 霄 癫
斋	制 海 找 孩 择 址 债 炸 晒 宅 栽 摘 旨 寨 斩
癸	规 贵 归 挂 鬼 柜 轨 催 跪 瑰 桂 闺 龟 硅 诡
珂	可 科 客 课 克 刻 颗 渴 壳 柯 磕 棵 苛 坷 忒
嗷	早 案 造 奥 澳 傲 熬 凹 瑶 豹 敖 袄 艹 蘑 懊
猩	行 性 星 精 亲 京 形 型 兴 幸 醒 姓 刑 睛 馨
鹫	就 九 究 酒 久 救 旧 纠 仇 舅 揪 玖 韭 灸 钮
僻	被 批 皮 屁 脾 疲 匹 披 啤 劈 譬 痞 坯 琵 毗
龚	工 公 功 共 供 综 攻 宫 贡 恭 筒 桶 讼 轰 巩
恕	数 书 熟 输 束 树 叔 殊 暑 疏 蔬 淑 抒 赎 薯
湃	才 太 被 代 再 待 牌 排 拍 派 盖 灾 迫 唉 柏
驭	于 语 育 愉 郁 愚 狱 愈 寓 俞 吁 钰 禺 芋 煜
纶	关 管 观 官 馆 惯 冠 钻 贯 劝 灌 莞 罐 棺 竿
肛	刚 港 访 央 棒 钢 攻 岗 杭 仰 纲 杠 旸 纺 庞
沽	股 故 古 顾 估 鼓 固 骨 孤 姑 谷 雇 辜 菇 箍
譬	被 皮 屁 脾 疲 匹 披 僻 癖 痞 坯 霹 琵 毗 媲
袄	早 案 造 奥 澳 傲 熬 凹 瑶 豹 敖 嗷 艹 蘑 懊
锯	车 具 据 剧 句 居 巨 聚 距 拒 拘 矩 菊 焗 狙
蜘	之 知 只 至 指 支 职 执 止 织 址 枝 芝 旨 吱
菠	包 宝 博 播 波 伯 拨 剥 玻 勃 搏 泊 驳 脖 屄
棘	己 机 集 击 激 辑 既 寂 忌 稽 饥 姬 嫉 脊 妓
篱	理 里 力 利 立 历 离 黎 莉 厘 璃 隶 栗 哩 沥
竿	感 万 干 敢 赶 残 甘 盐 憾 杆 肝 尴 镐 赣 棺
蹄	体 题 提 替 徒 兔 剂 梯 踢 剔 漓 伺 唧 惕 涕
舵	多 盾 盗 拖 扩 洛 措 夺 朵 哆 躲 堕 妒 叨 剁
涕	体 题 提 替 徒 兔 剂 梯 踢 剔 漓 伺 唧 惕 蹄
笋	员 诉 随 苏 尊 损 伦 混 孙 塑 允 敦 逊 裙 匀
钧	军 均 伦 混 君 俊 允 锦 菌 逊 裙 勋 骏 峻 芸
拱	工 公 功 共 供 综 攻 宫 贡 恭 筒 桶 讼 轰 巩
蝇	应 影 英 营 迎 硬 映 赢 盈 颖 婴 樱 荧 萤 莺
僚	销 料 聊 疗 漂 炼 娇 吊 孝 辽 肖 郊 撩 饺 寥
俘	服 福 父 负 富 符 肤 辅 傅 覆 弗 敷 芙 辐 缚
眷	短 检 坚 健 软 监 端 圈 卷 捐 劵 倦 娟 柬 隽
拂	服 福 父 负 富 符 肤 辅 傅 覆 弗 敷 芙 辐 缚
迭	谢 写 贴 跌 揭 械 捷 灭 爹 蒂 蝶 碟 叠 堤 笛
榨	找 查 债 珠 哲 咋 扎 炸 渣 诈 罩 闸 眨 乍 栅
眨	找 查 债 珠 哲 咋 扎 炸 渣 诈 罩 闸 榨 乍 栅
喀	科 卡 克 亚 怕 苦 咯 咖 渴 壳 涯 蜡 腊 啪 哑
妾	接 结 且 球 切 铁 截 侵 仇 憋 窃 岂 咧 竭 屑
窟	付 足 句 苦 库 哭 酷 宿 咯 屋 欲 促 距 裤 狱
臀	论 土 询 迅 腿 盾 吐 坦 巡 敦 菌 吞 旬 熏 屯
邑	艺 依 异 亦 姨 翼 乙 抑 逸 疫 毅 溢 奕 弈 祎
艹	博 早 案 造 奥 澳 傲 熬 凹 瑶 敖 嗷 袄 蘑 懊
诫	接 结 节 界 姐 介 街 借 截 揭 捷 戒 皆 劫 羯
烹	朋 曾 登 灯 聘 碰 萌 崩 捧 鹏 扔 彭 棚 蓬 膨
捂	五 务 物 武 舞 悟 乌 伍 勿 吾 坞 侮 梧 毋 钨
釉	有 又 游 由 优 油 右 邮 尤 幼 忧 幽 犹 诱 呦
煽	山 善 顺 占 删 闪 扇 陕 擅 衫 珊 杉 汕 姗 讪
鲤	理 里 力 利 立 历 离 黎 莉 厘 璃 隶 栗 哩 沥
惦	点 电 店 段 连 典 垫 莲 廉 辨 吊 颠 淀 殿 扂
娅	亚 呀 压 雅 牙 押 涯 鸭 谊 丫 吖 芽 讶 哑 幺
逍	小 笑 消 销 效 漂 晓 孝 肖 萧 削 宵 潇 衔 嚣
弧	户 护 互 乎 湖 呼 胡 虎 忽 糊 狐 沪 壶 蝴 葫
琉	六 流 球 究 留 刘 鹿 柳 浏 溜 瘤 咧 榴 硫 吏
贰	二 而 儿 哦 尔 额 恶 恩 耳 饿 鹅 饵 噩 厄 遏
雌	次 此 词 急 笔 益 依 击 材 刺 辞 圾 磁 慈 瓷
剃	体 题 提 替 徒 兔 剂 梯 踢 剔 漓 伺 唧 惕 蹄
镁	没 美 每 妹 媒 危 梅 煤 魅 眉 玫 霉 枚 昧 媚
酥	诉 速 素 熟 舞 苏 宿 俗 塑 傅 肃 凸 醋 吾 舆
渲	选 宣 旋 悬 暅 炫 玄 轩 萱 喧 绚 璇 嬛 眩 漩
噜	路 录 陆 绿 鲁 炉 卢 碌 芦 璐 卤 庐 禄 泸 虏
瞩	主 注 住 助 祝 筑 猪 逐 珠 竹 驻 柱 煮 丶 烛
怯	接 结 求 且 切 铁 截 侵 憋 琪 窃 屑 祈 伽 茄
匣	下 西 喜 价 消 夏 席 侠 瞎 霞 萧 虾 辖 峡 狭
烙	老 报 造 络 跑 劳 赖 矛 牢 捞 姥 佬 拦 唠 袍
阱	经 精 境 静 竞 镜 净 敬 睛 径 晶 井 颈 殑 荆
莽	帮 忙 访 央 棒 洋 钢 坊 茫 汪 盲 躺 芒 沧 妄
叼	交 笑 销 料 掉 吊 屌 雕 肖 萧 钓 翘 滇 霄 癫
扞	感 万 干 敢 赶 残 甘 贯 盐 憾 杆 肝 尴 攒 赣
驼	突 罗 坐 托 脱 腿 吐 拖 扩 拓 妥 吞 佐 凸 魄
庇	比 毕 笔 币 避 闭 鼻 彼 壁 碧 鄙 弊 臂 屄 哔
娥	哦 额 恶 俄 呃 饿 鹅 噩 厄 鄂 遏 讹 扼 胺 峨
沁	银 青 琴 勤 侵 秦 淫 巾 寝 茄 钦 禽 糗 旻 芹
酚	分 费 认 份 粉 恩 奋 菲 纷 笨 氛 奉 愤 芬 坟
炖	但 轮 润 顿 君 迅 盾 遵 锻 巡 敦 耽 吨 妒 蹲
藻	报 早 造 草 爆 昨 遭 稿 槽 糟 躁 澡 膏 燥 枣
焖	们 怎 门 肯 温 嚒 盟 仁 梅 魅 闷 孟 雯 媚 瞒
镖	表 标 条 笑 消 销 票 饱 胞 朴 钓 飙 彪 婊 撬
骆	落 罗 若 洛 夺 逻 裸 啰 萝 螺 囖 锣 灬 麓 涝
濑	来 海 利 孩 累 兰 灾 泪 勒 赖 莱 挨 唻 嘞 掰
烯	西 喜 习 吸 媳 晰 稀 溪 夕 兮 茜 犀 熄 嬉 羲
憎	总 政 风 增 曾 丰 凤 恒 坑 奉 赠 扔 孟 逢 耕
堰	验 严 延 炎 燕 盐 沿 岩 掩 宴 咽 衍 彦 妍 腌
蹬	当 等 登 灯 仍 碰 邓 崩 彭 橙 澄 蹭 盯 耿 懵
猿	院 元 远 源 愿 园 缘 圆 怨 援 袁 苑 冤 渊 媛
呛	强 向 签 娘 箱 抢 枪 墙 粮 晴 蒋 腔 氢 晾 仟
蘑	模 默 魔 末 摩 莫 磨 摸 膜 墨 陌 脉 寞 抹 漠
冉	然 板 饭 盘 染 燃 壬 攀 刃 贩 炭 滥 婉 扳 焊
拭	什 实 师 试 世 视 式 使 失 识 示 士 适 饰 狮
禹	于 育 愉 郁 愚 狱 愈 寓 俞 吁 驭 钰 禺 芋 煜
耸	红 共 送 供 控 松 聪 宋 讼 轰 诵 颂 雍 嵩 怂
睫	接 结 节 界 介 街 借 洁 截 揭 皆 劫 羯 竭 桔
吝	李 林 列 丽 临 邻 劣 璃 琳 淋 赁 锌 麟 霖 磷
珑	总 龙 宫 隆 涌 葱 笼 诵 垄 拢 聋 胧 陇 咙 泷
盎	让 安 帮 阳 往 藏 堂 档 扬 抗 汤 仿 昂 芳 脏
癖	被 皮 屁 脾 疲 匹 披 啤 劈 僻 譬 痞 坯 霹 琵
棱	灵 浪 嗡 冷 蒙 冯 扔 孟 蓬 耿 懵 膨 愣 朦 拎
焉	验 延 炎 燕 盐 沿 岩 掩 宴 咽 衍 彦 妍 腌 堰
聋	总 龙 宫 隆 涌 葱 笼 诵 垄 拢 珑 胧 陇 咙 泷
祁	七 气 汽 妻 骑 棋 歧 琪 岂 祈 乞 琦 凄 绮 砌
怠	代 孩 带 待 材 嘚 贷 莱 戴 呆 袋 歪 歹 黛 逮
煲	保 报 号 包 宝 操 抱 爆 暴 薄 逃 饱 堡 恼 剥
樟	长 张 终 章 航 掌 账 涨 障 帐 丈 肿 胀 仗 彰
恺	开 待 卖 态 载 牌 财 排 拍 害 嘅 凯 慨 狸 汰
橄	感 万 干 敢 兰 赶 残 甘 贯 盐 憾 杆 肝 尴 攒
翡	费 非 飞 肥 菲 废 啡 肺 磊 妃 匪 沸 绯 酚 斐
颓	台 规 推 退 罪 脱 腿 恢 催 兑 怼 髓 贿 蜕 褪
茧	间 建 见 检 坚 健 监 荐 键 剑 兼 剪 艰 舰 奸
郡	军 均 尊 伦 混 君 俊 允 锦 菌 逊 裙 倦 骏 峻
呱	挂 锅 柜 瓜 夸 莞 裹 雇 刮 卦 寡 褂 椁 皈 旮
秧	样 营 养 阳 杨 央 洋 扬 羊 仰 氧 旸 痒 烊 漾
聂	节 写 界 且 逆 蝶 匿 捏 疟 鳎 咩 孽 迭 妾 诫
滔	早 套 讨 淘 邀 逃 桃 陶 涛 膏 捣 萄 掏 苞 韬
灼	做 助 祝 著 桌 卓 竹 捉 丶 爪 诛 拙 浊 辍 酌
缉	己 机 集 击 激 吉 辑 既 寂 忌 稽 饥 姬 嫉 脊
垣	原 院 元 远 源 愿 园 缘 圆 怨 援 袁 苑 冤 渊
瞄	校 猫 脚 描 妙 秒 飘 苗 帽 喵 庙 蕉 撩 飙 渺
荫	因 音 银 引 印 阴 隐 饮 姻 淫 瘾 吟 殷 尹 倚
翟	制 海 找 孩 择 址 占 债 炸 晒 宅 栽 摘 旨 寨
炜	微 未 维 委 味 威 谓 唯 魏 韦 畏 蔚 巍 惟 潍
黔	前 钱 千 签 潜 迁 欠 牵 歉 谦 遣 铅 乾 倩 嵌
钝	蛋 讯 顿 迅 盾 遵 锻 巡 敦 堕 耽 吨 妒 蹲 屯
嚷	让 房 望 防 党 仿 荡 邦 仰 杠 壤 肪 镑 烊 傍
膊	接 利 介 礼 列 临 烈 裂 黎 莉 猎 劣 蝶 咧 榴
嗝	个 格 歌 各 根 哥 革 隔 割 戈 葛 鸽 阁 搁 嘎
哔	比 毕 笔 币 避 闭 鼻 彼 壁 碧 鄙 弊 臂 屄 庇
绚	选 宣 旋 悬 暅 炫 玄 轩 萱 喧 渲 璇 嬛 眩 漩
徊	华 块 怀 坏 帅 挥 慧 绘 淮 亥 焕 卉 桓 晖 槐
隘	爱 细 哎 艾 疾 亦 唉 碍 埃 欸 挨 哀 癌 凹 矮
篷	朋 曾 登 灯 聘 碰 萌 崩 捧 鹏 扔 彭 棚 蓬 膨
甫	服 福 父 负 府 附 妇 符 幅 辅 覆 抚 赴 敷 辐
徘	才 太 被 代 再 待 牌 排 拍 派 盖 灾 迫 唉 柏
梓	自 子 资 字 咨 仔 紫 姿 滋 兹 孜 籽 淄 疵 呲
杖	长 商 张 终 众 章 航 掌 账 涨 障 帐 丈 肿 胀
鸠	就 九 究 酒 久 救 旧 纠 舅 揪 玖 韭 灸 钮 疚
宛	完 万 玩 晚 饭 范 湾 弯 碗 挽 塆 丸 妄 婉 顽
茬	差 楚 察 沙 触 茶 插 储 扎 莎 叉 耻 蝉 岔 榨
眸	由 模 否 某 幕 厚 摩 沟 莫 膜 谋 喽 酉 喉 钩
寅	因 音 银 引 印 阴 隐 饮 姻 淫 瘾 吟 殷 尹 倚
郸	但 单 担 严 翻 暗 蛋 淡 丹 旦 胆 诞 耽 氮 惮
绮	七 气 汽 妻 骑 棋 歧 琪 岂 祈 乞 琦 凄 祁 砌
伶	零 精 领 另 灵 令 龄 凌 玲 铃 陵 岭 菱 聆 拎
馒	满 范 慢 漫 兰 贸 蛮 曼 番 炎 埋 迈 滥 婉 谭
婿	需 许 续 须 苏 序 附 虚 绪 徐 蓄 叙 旭 畜 絮
隧	失 识 规 死 随 岁 虽 罪 损 碎 瑰 髓 贿 遂 穗
棠	痛 堂 羊 唐 糖 汤 盲 躺 塘 趟 烫 枉 倘 淌 膛
砌	七 气 汽 妻 骑 棋 歧 琪 岂 祈 乞 琦 凄 祁 绮
蔑	别 民 介 协 跌 捷 灭 携 胁 羯 窃 懈 咩 瘪 谬
迦	家 加 价 叫 假 佳 架 驾 甲 嘉 嫁 剪 夹 贾 钾
绸	早 套 讨 淘 邀 逃 稿 桃 陶 涛 捣 萄 掏 苞 韬
叽	己 机 集 击 激 吉 辑 既 寂 忌 稽 饥 姬 嫉 脊
晾	两 量 讲 亮 练 恋 奖 良 令 朗 辆 梁 凉 粮 祥
籁	来 海 利 孩 奶 累 兰 灾 泪 勒 赖 莱 挨 唻 嘞
婪	般 兰 蓝 览 烂 懒 篮 栏 唻 肝 琳 滥 拦 澜 揽
绞	教 交 校 较 叫 角 脚 焦 胶 骄 椒 矫 搅 蕉 饺
讪	山 善 汉 删 闪 扇 陕 擅 衫 珊 杉 汕 姗 煽 膳
畔	难 盘 判 残 胖 栏 艳 燕 坎 尴 盼 潘 叛 攀 晗
毋	五 无 务 物 武 舞 悟 乌 伍 勿 坞 侮 梧 捂 钨
钾	家 加 价 叫 假 佳 架 驾 甲 嘉 嫁 剪 夹 贾 迦
疣	有 友 又 游 由 优 油 右 邮 尤 幼 忧 幽 犹 诱
晖	回 惠 汇 慧 灰 悔 辉 徽 毁 绘 恢 贿 卉 晦 荟
蜕	台 规 推 退 罪 脱 腿 恢 催 兑 怼 髓 贿 颓 褪
穗	失 识 规 死 随 岁 虽 罪 损 碎 瑰 髓 贿 遂 隧
亢	帮 养 阳 康 洋 钢 抗 朗 绑 杭 氧 旸 烫 缸 冈
汶	文 问 微 温 卫 粉 闻 稳 纹 吻 畏 挽 雯 蚊 潍
嗜	事 什 实 师 试 世 视 式 使 失 识 示 士 适 饰
跺	多 盾 盗 拖 扩 洛 措 夺 朵 哆 躲 堕 妒 叨 剁
矣	艺 依 异 亦 姨 翼 乙 抑 逸 疫 毅 溢 奕 弈 祎
粽	总 容 弄 综 荣 勇 攻 宗 纵 踪 佣 匆 栋 丛 蓉
悼	到 道 导 倒 岛 刀 澳 旦 冒 傲 戴 胆 盗 呆 邀
讹	哦 额 恶 俄 呃 鹅 噩 厄 鄂 遏 娥 扼 峨 鳄 愕
筷	开 快 块 乖 慨 淮 拐 楷 窥 恺 盔 魁 匮 槐 胯
沮	车 具 据 剧 局 居 巨 聚 距 拒 拘 矩 菊 橘 狙
熄	西 喜 习 吸 媳 晰 溪 夕 兮 茜 玺 曦 犀 烯 嬉
捅	同 通 总 统 痛 童 腾 铜 筒 桶 讼 桐 彤 瞳 珑
臼	就 九 究 即 酒 久 救 旧 纠 舅 揪 绣 浸 玖 韭
悚	红 共 送 供 永 松 聪 宋 鸿 讼 轰 诵 颂 雍 嵩
隋	失 识 始 死 随 岁 虽 罪 损 碎 髓 贿 遂 隧 穗
辫	变 见 边 险 编 签 遍 填 仙 辩 辨 羡 颠 咁 奸
斧	服 福 父 负 富 幅 肤 辅 傅 覆 弗 敷 芙 缚 阜
倘	痛 堂 羊 唐 糖 汤 盲 躺 塘 趟 烫 枉 棠 漾 淌
藩	反 饭 范 翻 烦 犯 访 凡 繁 返 泛 番 帆 贩 揽
脐	七 汽 妻 骑 棋 歧 琪 岂 祈 乞 琦 凄 祁 绮 砌
袱	服 福 父 负 富 府 符 肤 辅 傅 覆 弗 敷 芙 缚
垦	任 客 根 肯 恩 困 稳 忍 仁 壳 昆 愤 吻 堪 坎
盔	随 鬼 亏 阔 馈 愧 溃 葵 窥 魁 奎 匮 祟 傀 睽
邂	些 解 谢 写 协 鞋 械 邪 谐 蟹 泄 蝎 歇 卸 胁
疵	自 子 资 字 咨 仔 紫 姿 兹 孜 籽 淄 梓 呲 渍
髦	妈 马 毛 猫 贸 貌 冒 矛 妖 炮 涛 迈 烤 帽 茅
逅	友 候 够 购 构 狗 沟 勾 呦 吼 雇 钩 苟 垢 鸥
柿	事 什 实 师 试 世 视 式 使 失 识 示 士 适 饰
嚏	体 题 提 依 替 徒 兔 梯 踢 剔 漓 唧 惕 蹄 涕
钳	前 钱 千 潜 迁 欠 牵 歉 谦 遣 铅 乾 倩 嵌 谴
躬	工 公 东 从 功 共 供 攻 恐 宫 贡 恭 泳 踪 鸿
阎	验 延 炎 燕 盐 沿 掩 宴 咽 衍 彦 妍 腌 堰 晏
邯	般 汉 韩 含 寒 涵 喊 汗 憾 函 扇 撼 旱 晗 焊
梢	少 号 找 杀 绍 烧 稍 闪 召 吵 耗 纱 嫂 衫 邵
矶	己 机 集 击 激 吉 辑 既 寂 忌 稽 饥 姬 嫉 脊
嗽	游 构 搜 尤 舒 幽 犹 肃 疏 呦 吼 搂 艘 柚 曙
唾	退 罗 坐 托 脱 吐 拖 扩 拓 妥 掏 吞 佐 凸 魄
锣	落 罗 洛 惑 逻 裸 啰 萝 裹 螺 囖 沦 骆 灬 涝
磷	李 林 丽 临 邻 璃 琳 淋 赁 锌 麟 霖 吝 旻 芹
盏	展 站 战 占 粘 撼 兆 擅 颤 旱 詹 沾 斩 湛 绽
帜	之 知 只 至 指 支 职 执 止 织 址 枝 芝 旨 吱
艘	游 构 某 搜 舒 幽 犹 疏 呦 吼 墅 搂 嗽 柚 曙
娄	又 路 头 楼 否 录 露 豆 陆 搜 漏 炉 喽 苟 陋
倔	觉 决 绝 居 君 掘 爵 诀 崛 抉 炬 厥 獗 桀 钜
胳	个 格 歌 各 哥 革 隔 割 戈 葛 鸽 阁 搁 辜 磕
糗	求 球 秋 齐 纠 驱 仇 溜 丘 玖 伽 邱 囚 妾 咻
缕	力 录 律 率 旅 虑 侣 璃 履 吕 滤 驴 铝 屡 哩
魁	快 鬼 嘴 亏 馈 愧 溃 葵 窥 盔 奎 匮 祟 傀 睽
扼	哦 额 恶 俄 呃 饿 鹅 噩 厄 鄂 遏 讹 胺 峨 鳄
朦	等 名 梦 腾 盟 蒙 疯 萌 猛 冯 孟 泵 懵 绷 凳
嘀	地 第 低 底 弟 递 帝 滴 迪 抵 敌 蒂 堤 笛 旳
痹	比 毕 币 逼 避 闭 彼 壁 碧 鄙 辟 臂 屄 毙 庇
氯	力 录 律 率 旅 虑 侣 璃 履 吕 滤 驴 铝 屡 哩
拎	零 领 另 灵 令 龄 凌 玲 铃 陵 岭 菱 聆 伶 羚
拣	间 建 见 检 坚 监 荐 键 剑 兼 剪 艰 舰 奸 茧
崭	展 站 战 汉 占 丈 粘 兆 颤 詹 沾 翰 斩 湛 铲
酮	动 东 总 懂 党 融 冬 洞 董 浓 冻 鸿 涌 栋 溶
迩	二 而 儿 哦 尔 额 恶 恩 耳 饿 饵 厄 遏 贰 胺
羹	更 峰 攻 仍 凤 猛 杠 耕 梗 庚 蓬 缸 弓 耿 憎
皋	高 告 搞 貌 毫 泡 澳 冒 郭 傲 甘 稿 糕 膏 镐
柑	感 万 干 敢 兰 赶 残 甘 贯 盐 憾 杆 肝 尴 攒
晟	生 证 身 城 声 省 争 升 征 胜 圣 症 剩 衡 呈
胺	哦 额 恶 俄 呃 饿 鹅 噩 厄 鄂 遏 讹 扼 峨 鳄
泸	路 录 绿 鲁 鹿 卢 撸 芦 璐 卤 庐 禄 噜 虏 麓
惶	黄 床 皇 荒 凰 谎 慌 煌 晃 恍 桓 疮 幢 簧 潢
赘	水 制 择 致 追 嘴 灰 朱 徽 毁 竹 枝 捉 坠 椎
痞	被 皮 屁 脾 疲 匹 披 啤 劈 僻 譬 坯 霹 琵 毗
桦	话 化 哈 或 花 华 画 划 怀 慧 忽 灰 滑 霍 刮
裳	上 长 商 伤 账 尚 赏 圣 剩 闪 杭 丧 昇 擅 杉
檀	谈 慢 弹 探 坛 坦 摊 贪 叹 碳 滩 炭 烫 吞 谭
惭	演 研 参 餐 暗 蛋 藏 赶 残 懒 诞 惨 尴 掩 灿
叁	三 山 班 干 演 淡 含 散 犯 诞 潘 宴 叛 咽 伞
褪	台 规 推 退 罪 脱 腿 拓 恢 催 兑 髓 贿 颓 蜕
屿	于 语 育 愉 郁 羽 愚 狱 愈 寓 俞 吁 钰 禺 芋
奎	快 鬼 嘴 亏 馈 愧 溃 葵 窥 盔 魁 匮 祟 傀 睽
旻	民 命 敏 淫 筋 浸 谜 吟 殷 泌 闽 缅 霖 吝 芹
芹	音 近 弃 琴 勤 侵 秦 琪 寝 崎 钦 禽 妾 沁 迄
晦	会 回 惠 汇 挥 慧 辉 徽 毁 绘 恢 贿 讳 卉 晖
垢	友 候 够 购 构 狗 沟 姑 勾 呦 吼 雇 钩 苟 逅
兢	经 精 京 境 景 警 惊 镜 净 敬 睛 径 晶 井 颈
痰	谈 慢 弹 探 坛 坦 摊 贪 叹 碳 滩 炭 烫 吞 谭
鸥	族 邮 鱼 木 苏 湖 欧 偶 喽 酉 瑜 喉 芦 钩 殴
漱	书 术 熟 输 束 树 舒 殊 暑 鼠 疏 蔬 抒 赎 竖
鲨	哈 视 设 势 啥 杀 沙 傻 狮 烧 叔 厦 纱 莎 蚀
遛	六 流 球 究 留 刘 鹿 柳 浏 溜 瘤 咧 榴 硫 吏
卒	组 足 族 租 虚 陆 巨 偶 聚 祖 阻 狐 诅 戮 戊
闵	民 命 密 敏 筋 浸 吟 彬 殷 泌 闽 缅 吝 寅 旻
糯	做 果 左 若 伙 诺 拖 洛 措 妥 奴 裹 螺 佐 挪
乍	制 找 查 志 债 哲 咋 扎 炸 渣 诈 罩 闸 榨 眨
娴	现 先 限 险 显 县 鲜 仙 陷 嫌 贤 羡 咁 纤 弦
悯	民 命 密 敏 筋 浸 吟 彬 殷 泌 闽 缅 吝 寅 旻
鳞	李 林 临 邻 劣 璃 琳 淋 赁 锌 麟 霖 吝 磷 旻
铠	开 待 卖 态 载 牌 财 排 拍 材 嘅 凯 溃 慨 狸
忻	心 新 信 希 惜 欣 辛 薪 巡 羡 夕 芯 鑫 锌 邢
锄	出 吃 处 初 除 楚 础 触 储 筹 厨 酬 蔬 丶 橱
缪	校 猫 脚 描 妙 秒 飘 苗 帽 喵 庙 撩 飙 渺 刁
蔻	友 候 口 构 某 苦 扣 幼 奏 呦 吼 枯 抠 逅 嗽
炬	车 具 据 剧 局 居 巨 聚 距 拒 拘 矩 菊 狙 鞠
绥	失 识 规 死 随 岁 虽 罪 损 碎 脆 髓 贿 遂 隧
珀	被 破 婆 摩 霸 屁 坡 噢 寞 抹 颇 泼 渤 袍 陂
狡	教 交 校 较 叫 角 脚 焦 胶 娇 骄 矫 搅 蕉 饺
钛	太 白 台 态 哎 泰 胎 桃 陶 挨 哀 摊 抬 汰 毯
拧	清 星 精 宁 苹 倾 赢 刑 凝 卿 菱 擎 璟 腥 鲸
殆	代 海 带 待 材 嘚 贷 莱 戴 麦 呆 袋 歪 歹 黛
麒	七 气 汽 妻 骑 棋 歧 琪 岂 祈 乞 琦 凄 绮 砌
竣	军 均 伦 混 君 俊 允 锦 菌 逊 裙 勋 骏 峻 芸
糜	米 密 迷 秘 蜜 眉 弥 咪 谜 幂 泌 靡 觅 眯 矶
肘	候 收 周 州 洲 煮 侯 宙 舟 吼 骤 轴 丶 喉 咒
靳	进 金 今 近 尽 仅 紧 津 禁 劲 斤 锦 谨 晋 巾
禧	西 喜 习 息 希 吸 惜 媳 晰 夕 兮 茜 隙 玺 烯
谛	地 第 低 底 弟 递 帝 滴 迪 抵 敌 蒂 堤 笛 旳
呲	自 子 资 字 咨 紫 姿 滋 兹 孜 籽 淄 梓 疵 渍
笙	生 整 声 省 升 尚 胜 圣 盛 症 剩 呈 昇 牲 绳
蒿	好 海 号 药 豪 潮 貌 毫 傲 耗 浩 凹 涛 烤 嚎
晏	验 延 炎 燕 盐 沿 岩 掩 宴 咽 衍 彦 妍 腌 堰
驯	婚 训 询 寻 讯 迅 循 遵 巡 逊 旬 勋 熏 绚 薰
咐	服 付 父 富 府 附 妇 幅 肤 傅 抚 弗 辐 缚 俯
祠	次 此 词 急 笔 益 依 礼 击 材 刺 辞 唉 磁 慈
胧	龙 浪 宫 聪 宋 隆 鸿 葱 笼 溶 垄 拢 珑 聋 陇
佟	同 通 总 统 痛 童 铜 筒 桶 躺 婷 桐 彤 瞳 珑
翩	片 便 限 连 票 简 篇 骗 田 偏 扁 嵌 巅 碘 奠
陇	龙 宫 宋 隆 葱 笼 诵 垄 拢 珑 聋 胧 咙 泷 淞
涤	地 第 低 底 弟 递 帝 滴 迪 抵 敌 蒂 堤 笛 旳
窜	原 院 选 环 软 寸 串 旋 贯 悬 眷 猿 惭 篡 蹿
萤	应 影 英 硬 映 赢 盈 颖 婴 鹰 樱 莹 荧 蝇 莺
灬	活 或 货 火 获 昨 伙 魂 扩 惑 霍 祸 豁 壕 镯
漳	长 商 张 终 众 章 航 掌 账 涨 障 帐 丈 肿 胀
斐	费 非 飞 肥 菲 废 慰 啡 肺 磊 妃 匪 沸 绯 翡
匡	光 况 狂 宽 矿 逛 荒 框 凰 慌 恍 旷 眶 筐 炕
丞	成 程 城 承 陈 诚 盛 乘 症 挣 撑 呈 肠 辰 趁
迄	七 气 汽 妻 旗 骑 棋 歧 琪 岂 祈 乞 琦 凄 绮
墩	单 度 村 顿 盾 哆 躲 敦 吨 蹲 惰 囤 炖 郡 钝
冢	中 种 长 重 总 终 众 钟 忠 虫 帐 仲 肿 衷 弘
窖	教 交 校 较 叫 角 脚 焦 胶 骄 椒 矫 搅 蕉 浇
豚	团 村 谈 困 孙 迅 徒 俊 叹 循 菌 吞 陀 毯 屯
寇	友 候 口 构 某 苦 扣 幼 奏 呦 吼 枯 抠 逅 嗽
臻	真 镇 针 珍 圳 震 阵 诊 振 侦 贞 甄 枕 帧 疹
忒	特 德 各 色 图 客 核 厕 涂 饿 渴 肋 梯 啧 琊
缤	音 近 边 遍 避 欣 宾 碧 滨 饼 辨 谨 斌 彬 尹
蓑	所 错 苏 索 锁 缩 洛 措 惑 夺 扫 霍 琐 嫂 琢
阮	软 券 幻 缘 圆 卷 润 冠 酸 染 患 缓 怨 泉 旋
栓	算 换 环 刷 川 赚 缓 闪 摔 甩 霜 擅 汕 煽 痪
洱	二 而 儿 哦 尔 额 恶 耳 饿 鹅 饵 厄 遏 贰 娥
惚	不 部 步 补 布 趣 波 顾 捕 屈 怖 卜 疤 埠 凸
氟	服 付 父 富 府 附 妇 幅 肤 傅 抚 弗 辐 缚 俯
俐	理 里 力 利 立 历 离 黎 莉 厘 璃 隶 栗 哩 沥
浊	火 伙 著 桌 卓 捉 丶 豁 坠 拙 灼 赘 酌 镯 茁
萃	才 此 持 队 汇 碎 催 慈 脆 痴 馈 粹 翠 崔 摧
俪	理 里 力 利 立 历 离 黎 莉 厘 璃 隶 栗 哩 沥
陛	比 毕 币 逼 避 闭 彼 壁 碧 鄙 辟 臂 屄 毙 庇
嬉	西 喜 习 息 希 吸 惜 媳 晰 夕 锡 兮 茜 隙 玺
簧	黄 床 皇 荒 凰 谎 慌 煌 晃 恍 桓 疮 幢 惶 潢
淆	小 笑 消 销 效 晓 孝 苗 肖 萧 削 宵 潇 搅 嚣
渭	微 未 维 委 味 威 谓 唯 魏 韦 畏 蔚 巍 惟 潍
汲	己 机 集 积 击 激 吉 辑 既 寂 忌 稽 饥 姬 嫉
辍	错 获 楚 纯 炒 吵 豁 戳 雏 淳 烁 绰 嚯 龊 滁
瀑	普 促 距 铺 吐 辅 污 谱 悟 驱 扑 浦 葡 菩 埔
峨	哦 额 恶 俄 呃 鹅 噩 厄 鄂 遏 娥 讹 扼 鳄 愕
嗑	可 科 客 课 克 刻 哭 颗 渴 壳 柯 磕 棵 苛 坷
泾	经 精 境 景 警 惊 竞 镜 敬 睛 晶 井 颈 荆 靖
跋	吧 八 把 哪 报 爸 巴 压 搬 拔 芭 罢 胞 叭 疤
炳	请 并 病 冰 兵 屏 凌 饼 丙 泵 钉 秉 柄 濒 菁
漾	样 营 眼 养 阳 杨 央 洋 扬 羊 仰 氧 旸 痒 烊
荤	户 运 华 准 婚 伦 混 幻 呼 魂 遵 浑 昏 仑 焕
拇	目 母 顾 族 舞 麻 鱼 木 幕 慕 姆 牧 墓 募 敷
惘	网 让 望 玩 帮 王 往 忘 亡 旁 汤 仿 荡 旺 汪
柚	有 友 又 游 由 优 油 右 邮 尤 幼 忧 幽 犹 诱
彷	帮 朋 王 港 瓶 糖 旁 汤 胖 仿 庞 萍 葬 廊 拌
苇	微 未 维 委 味 威 谓 唯 魏 韦 畏 蔚 巍 惟 潍
刨	毛 婆 跑 劳 抱 派 草 爆 判 泡 炮 抛 掏 豹 枣
蔫	年 片 南 边 念 偏 填 仙 莲 殿 纤 遣 铅 碱 敛
烨	也 业 夜 爷 野 页 叶 欲 隔 液 耶 椰 冶 噎 琊
仟	前 钱 千 签 潜 迁 牵 歉 谦 遣 铅 乾 倩 嵌 黔
佼	教 交 校 较 叫 角 脚 焦 胶 娇 骄 矫 搅 蕉 饺
扉	费 非 飞 肥 菲 废 啡 肺 妃 匪 沸 绯 翡 斐 诽
荟	回 惠 汇 慧 灰 悔 辉 徽 毁 绘 恢 贿 卉 晖 晦
咦	艺 依 遗 亦 姨 翼 乙 抑 逸 疫 毅 溢 奕 弈 祎
诅	组 足 族 租 虚 陆 巨 偶 聚 祖 阻 卒 戮 戊 仄
钰	于 育 誉 愉 郁 愚 狱 愈 寓 俞 吁 驭 禺 芋 煜
惬	接 结 求 且 切 铁 截 侵 憋 琪 窃 屑 祈 伽 茄
慷	帮 养 康 榜 洋 钢 抗 朗 绑 孔 旸 烫 缸 冈 扛
撵	年 片 南 边 念 偏 填 仙 莲 殿 纤 遣 铅 碱 黏
渍	自 子 资 字 咨 仔 紫 姿 滋 兹 孜 籽 淄 梓 疵
箍	股 故 古 顾 估 鼓 固 骨 孤 姑 谷 雇 辜 菇 咕
禺	于 育 誉 愉 郁 愚 狱 愈 寓 俞 吁 驭 钰 芋 煜
悖	费 北 备 背 卫 悲 贝 违 辈 杯 倍 呗 碑 卑 佰
绰	错 获 楚 纯 炒 吵 豁 戳 雏 淳 烁 辍 嚯 龊 滁
夭	要 约 药 摇 邀 腰 妖 耀 遥 咬 谣 岆 瑶 姚 钥
洼	完 亚 怕 罚 娃 挖 哇 瓦 勿 挽 啪 袜 靶 鸦 蜗
丨	故 军 冠 滚 灌 浑 雇 昏 坤 硅 罐 刮 吨 棍 卦
鳄	哦 额 恶 俄 呃 饿 鹅 噩 厄 鄂 遏 讹 扼 胺 峨
吭	放 王 航 账 畅 横 绑 杭 哼 谎 氧 鸿 磅 杖 倘
皖	完 万 玩 晚 饭 盘 湾 弯 碗 挽 塆 丸 妄 婉 顽
婕	接 结 节 界 介 街 借 阶 截 揭 捷 戒 劫 羯 桔
侬	东 从 农 拥 松 弄 董 宋 孔 浓 蓉 颂 桐 胧 佟
酌	火 伙 著 桌 卓 竹 捉 丶 坠 拙 灼 赘 浊 镯 茁
陂	被 破 婆 摩 霸 墨 屁 坡 噢 抹 颇 泼 渤 袍 珀
瀚	般 汉 韩 含 寒 涵 喊 汗 憾 函 痕 扇 撼 旱 晗
侥	教 交 校 较 叫 角 脚 缴 焦 胶 娇 骄 郊 矫 搅
涅	节 写 界 逆 蝶 匿 捏 疟 咩 孽 迭 妾 诫 聂 榭
厮	四 司 思 死 斯 食 素 击 似 丝 私 撕 寺 肆 饲
螃	帮 朋 王 港 瓶 糖 旁 汤 胖 仿 庞 萍 葬 廊 拌
噬	事 什 实 师 试 世 视 式 使 失 识 示 士 适 饰
曙	书 术 熟 输 束 树 舒 殊 暑 鼠 疏 蔬 抒 赎 竖
虏	录 陆 绿 鲁 炉 卢 碌 撸 芦 璐 卤 庐 禄 噜 泸
嗅	修 秀 休 旧 羞 媳 仇 锡 袖 绣 昔 膝 钮 锈 朽
秽	回 惠 汇 慧 灰 悔 辉 徽 毁 绘 恢 贿 卉 晖 晦
菁	经 精 京 境 景 警 静 惊 竞 镜 净 敬 睛 晶 井
呸	费 未 配 培 陪 雷 伟 危 赔 佩 脾 薇 纬 沛 劈
桨	将 讲 江 奖 荐 降 竞 尖 剪 疆 姜 酱 蒋 僵 箭
阚	看 饭 盘 谈 范 慢 寒 刊 堪 砍 坎 侃 勘 炭 攒
唬	户 护 互 乎 湖 呼 胡 虎 忽 糊 狐 沪 壶 蝴 弧
娼	场 常 充 唱 厂 藏 涨 尚 偿 昌 尝 畅 肠 倡 仗
缎	观 店 款 段 断 短 端 泉 诞 援 旋 贯 劝 垫 拳
疙	个 格 歌 各 根 哥 革 隔 割 戈 葛 鸽 阁 搁 辜
镯	火 伙 著 桌 卓 竹 捉 丶 坠 拙 灼 赘 浊 酌 茁
冕	面 满 免 恋 献 垫 眠 棉 淀 绵 勉 渺 缅 俭 黔
潢	黄 床 皇 荒 凰 谎 慌 煌 晃 恍 桓 疮 幢 惶 簧
饪	人 分 本 认 任 跟 粉 闻 忍 润 仁 染 喷 闷 扔
廓	错 靠 罗 坐 括 缩 郭 拖 亏 扩 措 妥 阔 琐 枯
膳	算 山 善 顺 赏 占 删 闪 扇 陕 擅 衫 珊 杉 汕
咎	就 九 究 即 酒 久 救 旧 纠 舅 揪 绣 浸 玖 韭
啼	体 题 提 替 徒 兔 梯 踢 剔 漓 唧 惕 蹄 涕 剃
虔	前 钱 千 签 潜 迁 牵 歉 谦 遣 铅 乾 倩 嵌 谴
璇	选 宣 旋 悬 暅 炫 玄 轩 萱 喧 渲 绚 嬛 眩 漩
溅	间 建 见 检 坚 监 减 荐 键 剑 兼 剪 艰 舰 奸
瘩	大 打 单 带 达 答 呀 搭 罚 娜 涯 哒 嗒 睹 怠
慑	设 社 适 摄 舍 射 涉 沈 氏 吓 厦 蛇 奢 舌 蜀
锥	水 制 择 致 追 嘴 灰 朱 徽 毁 竹 枝 捉 坠 椎
筱	小 笑 消 销 效 晓 孝 苗 肖 萧 削 宵 潇 嚣 霄
藕	族 苏 湖 欧 偶 喽 酉 逾 瑜 喉 芦 钩 殴 呕 鸥
醛	全 权 券 幻 缘 圆 酸 潜 迁 患 泉 劝 拳 悬 谦
茗	明 名 命 境 庆 聘 瓶 敏 晶 鸣 铭 樱 颈 霆 冥
蛊	股 故 古 顾 估 鼓 固 骨 孤 姑 谷 雇 辜 菇 咕
娓	微 未 维 委 味 威 谓 唯 魏 韦 畏 蔚 巍 惟 潍
浒	户 护 互 乎 湖 呼 胡 虎 忽 糊 狐 沪 壶 蝴 弧
眶	光 况 狂 宽 矿 逛 荒 框 凰 慌 恍 旷 匡 筐 炕
茉	模 默 魔 末 摩 莫 磨 摸 膜 墨 陌 脉 寞 抹 漠
滕	等 更 风 腾 盟 疼 廷 霆 讽 棚 蚌 藤 愣 亨 甭
铬	个 格 歌 各 根 哥 革 隔 割 戈 葛 鸽 阁 搁 辜
瘟	文 问 温 闻 稳 纷 纹 氛 狠 吻 畏 挽 塆 雯 蚊
锂	理 里 力 利 立 历 离 黎 莉 厘 璃 隶 栗 哩 沥
芋	于 育 誉 愉 郁 愚 狱 愈 寓 俞 吁 驭 钰 禺 煜
裆	当 党 榜 档 唐 荡 昂 挡 桑 纺 庞 痒 瞪 壤 莽
裴	被 费 未 配 培 陪 雷 伟 危 赔 佩 脾 薇 纬 沛
炊	回 触 吹 恢 尺 催 厨 垂 唇 侈 崔 锤 晖 赘 晦
辄	这 着 者 致 折 喆 哲 浙 遮 煮 吱 辙 褶 蔗 啫
宕	当 党 榜 档 唐 荡 昂 挡 桑 纺 庞 痒 瞪 壤 莽
柒	七 汽 妻 旗 骑 棋 歧 琪 岂 祈 乞 琦 凄 绮 砌
烽	风 丰 封 灯 峰 疯 凤 锋 奉 猛 缝 蜂 冯 逢 讽
臆	艺 依 亦 姨 翼 乙 抑 逸 疫 毅 溢 奕 弈 祎 沂
璨	研 参 餐 暗 蛋 藏 残 懒 诞 惨 尴 掩 踩 灿 蚕
睬	买 才 卖 财 拍 彩 材 采 菜 哎 裁 猜 柏 袋 催
襟	进 金 今 近 究 您 尽 仅 紧 津 禁 劲 斤 锦 谨
轧	亚 呀 压 雅 牙 押 涯 鸭 洒 丫 吖 芽 讶 哑 鸦
帷	微 未 卫 威 谓 唯 伟 薇 魏 韦 畏 蔚 巍 惟 潍
汹	想 行 性 像 形 象 醒 箱 详 兄 姓 雄 穷 熊 胸
酯	之 知 只 至 指 支 职 执 止 织 址 植 枝 芝 旨
铂	博 播 波 魔 伯 拨 脉 剥 玻 勃 搏 泊 驳 脖 屄
阂	该 海 改 载 财 排 概 菜 盖 泰 鬼 奈 欸 矮 抬
杞	七 汽 妻 旗 骑 棋 歧 琪 岂 祈 乞 琦 凄 绮 砌
蝠	服 付 父 富 府 附 妇 幅 肤 傅 抚 弗 辐 缚 俯
胚	被 费 未 配 培 陪 雷 伟 危 赔 佩 脾 薇 纬 沛
杩	吗 妈 马 码 亚 怕 嘛 麻 猫 骂 玛 涯 祂 啪 沫
琊	也 业 夜 爷 野 页 叶 欲 娱 隔 液 耶 椰 冶 噎
钨	五 无 务 物 午 武 误 吴 屋 悟 乌 伍 雾 吾 巫
粟	诉 速 素 舞 苏 宿 俗 塑 傅 肃 凸 醋 吾 舆 巫
戛	家 加 价 假 角 佳 架 驾 甲 嘉 嫁 夹 贾 迦 钾
麓	路 录 绿 鲁 炉 卢 碌 撸 芦 璐 卤 庐 禄 噜 泸
驿	艺 依 异 亦 姨 翼 乙 抑 逸 疫 毅 溢 奕 弈 祎
濠	好 海 号 药 豪 潮 貌 毫 傲 耗 浩 凹 涛 烤 嚎
谤	并 放 房 帮 航 党 忙 榜 棒 邦 绑 杭 斑 脏 膀
孰	书 术 熟 输 束 树 舒 殊 暑 鼠 疏 蔬 梳 抒 赎
沌	专 转 传 换 穿 状 川 赚 船 钻 撞 砖 唤 粘 詹
蕊	罪 瑞 辉 恢 瑰 桂 馈 锐 硅 睿 髓 讳 葵 茹 卉
祺	七 汽 妻 旗 骑 棋 歧 琪 岂 祈 乞 琦 凄 绮 砌
肮	让 安 帮 阳 往 藏 堂 档 扬 抗 汤 仿 昂 芳 脏
莆	普 欲 铺 吐 辅 污 谱 悟 驱 扑 浦 葡 菩 埔 仆
哮	小 笑 消 销 效 晓 孝 霞 肖 萧 削 宵 潇 侨 嚣
檐	验 严 烟 颜 炎 艳 燕 盐 沿 岩 掩 宴 衍 腌 堰
诋	地 第 低 底 弟 递 帝 滴 迪 抵 敌 蒂 堤 笛 旳
瘸	确 且 却 切 绝 曲 趣 缺 驱 屈 裙 诀 崛 茄 靴
捶	回 触 吹 恢 尺 催 厨 垂 侈 崔 锤 晖 赘 晦 锄
闫	验 严 烟 颜 炎 艳 燕 盐 沿 岩 掩 宴 衍 腌 堰
墟	需 许 续 须 苏 序 雪 虚 绪 徐 蓄 叙 旭 畜 絮
莺	应 影 英 营 迎 硬 映 赢 盈 颖 婴 鹰 樱 荧 蝇
姊	自 子 资 字 咨 仔 紫 姿 滋 兹 孜 籽 淄 梓 疵
喱	理 里 力 利 立 历 离 黎 莉 厘 璃 隶 栗 哩 沥
徨	黄 床 皇 荒 凰 谎 慌 煌 晃 恍 桓 疮 幢 惶 簧
梆	并 放 房 帮 航 忙 榜 棒 邦 绑 杭 斑 脏 膀 壤
匮	亏 馈 愧 溃 坤 葵 垮 窥 盔 魁 奎 铠 蕊 傀 鲲
诧	差 楚 察 沙 触 茶 插 扎 莎 叉 耻 蝉 岔 榨 眨
酝	员 运 育 云 孕 允 晕 韵 蕴 匀 芸 耘 陨 昀 熨
蝙	片 便 限 连 票 简 篇 骗 田 偏 扁 嵌 巅 碘 奠
嘤	应 影 英 营 迎 硬 映 赢 盈 颖 鹰 樱 莹 荧 蝇
炙	之 知 只 至 指 支 职 执 止 织 址 植 枝 芝 旨
咙	龙 宫 宋 隆 涌 葱 笼 诵 垄 拢 珑 聋 胧 陇 泷
栅	找 展 查 志 债 咋 扎 炸 渣 诈 砸 闸 榨 眨 乍
菏	和 合 何 户 呵 河 核 喝 虎 涉 盒 荷 吓 赫 贺
坨	讨 索 托 脱 锁 拖 拓 妥 魄 屠 陀 驼 唾 糯 灬
趾	之 知 只 至 指 支 职 执 止 织 址 植 枝 芝 旨
忑	特 德 各 色 图 客 核 厕 涂 饿 渴 肋 梯 啧 忒
凋	交 笑 销 料 角 掉 吊 屌 雕 肖 萧 钓 侨 嚼 滇
璀	才 此 持 队 汇 碎 催 慈 脆 痴 馈 粹 翠 崔 摧
懊	博 早 案 造 奥 澳 傲 熬 凹 瑶 敖 嗷 袄 艹 蘑
亵	些 解 谢 写 协 鞋 械 邪 谐 蟹 携 泄 蝎 歇 卸
捎	少 号 找 杀 绍 烧 硕 稍 闪 召 吵 耗 嫂 衫 邵
淌	堂 羊 唐 糖 汤 丧 躺 塘 趟 烫 枉 棠 倘 忐 膛
衅	心 新 信 希 吸 欣 辛 薪 斤 逊 芯 筋 鑫 腥 锌
腑	服 付 父 富 府 附 妇 幅 肤 辅 傅 抚 弗 辐 缚
忐	谈 慢 弹 探 坛 坦 摊 贪 叹 碳 滩 炭 谭 扳 潭
嗣	四 司 思 死 斯 食 礼 似 丝 私 撕 寺 肆 饲 嘶
肴	要 约 套 药 摇 邀 腰 妖 耀 遥 咬 谣 岆 瑶 姚
逞	成 程 城 整 声 省 承 诚 盛 乘 尝 虫 撑 呈 秤
砺	理 里 力 利 历 励 厘 璃 哩 荔 吏 篱 鲤 俐 俪
怔	正 证 政 整 争 涨 征 震 郑 症 忠 挣 仲 肿 蒸
惮	但 单 担 严 翻 暗 蛋 淡 丹 旦 胆 诞 耽 氮 郸
巳	四 司 思 死 斯 食 礼 似 丝 私 撕 寺 肆 饲 嘶
掷	之 知 只 至 指 支 职 执 止 织 址 植 枝 芝 旨
薰	许 婚 训 询 寻 讯 迅 循 遵 巡 逊 旬 勋 熏 绚
惺	行 性 星 英 亲 京 形 型 兴 幸 醒 姓 薪 刑 睛
唑	作 做 错 座 左 坐 租 索 昨 洛 措 桌 遭 惑 夺
脓	总 农 懂 龙 弄 综 浓 冻 铜 庸 佣 匆 栋 丛 垄
耘	员 运 云 阅 孕 允 晕 韵 蕴 匀 芸 酝 陨 昀 熨
碣	可 科 客 课 克 刻 颗 渴 壳 葛 柯 磕 棵 苛 坷
嬷	模 默 魔 末 摩 莫 磨 摸 膜 墨 陌 脉 寞 抹 漠
咻	修 秀 休 旧 羞 媳 仇 锡 袖 绣 昔 膝 钮 锈 朽
坂	办 班 言 满 版 晚 眼 半 般 板 伴 棒 搬 颁 斑
凛	李 林 列 临 邻 劣 璃 琳 淋 赁 锌 麟 霖 吝 磷
蟆	吗 妈 马 码 亚 怕 嘛 麻 猫 骂 玛 涯 祂 沫 靶
沼	号 找 展 照 招 赵 桌 遭 召 耗 扎 兆 罩 昭 爪
斓	络 兰 蓝 览 烂 懒 篮 栏 滥 婉 谭 拦 翰 澜 揽
璧	比 毕 笔 币 避 闭 鼻 彼 壁 碧 鄙 弊 臂 屄 庇
赦	书 设 社 适 摄 舍 射 涉 氏 吓 厦 蛇 奢 舌 蜀
惋	完 万 玩 晚 湾 挖 弯 碗 挽 塆 丸 婉 顽 腕 宛
瑾	进 金 今 近 究 您 尽 仅 紧 津 禁 劲 斤 锦 谨
赃	航 钢 咱 障 扬 仓 亡 芳 脏 氧 葬 冈 舱 扛 壤
簇	趣 顾 族 舞 鱼 促 粗 崔 逾 瑜 凸 醋 妒 吾 舆
摁	而 根 温 恩 恨 氛 狠 吻 韧 噩 焚 汾 焖 扼 胺
诽	内 费 非 飞 肥 菲 废 啡 肺 妃 匪 沸 绯 翡 斐
猖	场 常 张 唱 章 厂 偿 昌 尝 畅 丈 肠 胀 倡 敞
蔼	爱 细 哎 艾 亦 唉 碍 埃 欸 挨 哀 癌 凹 矮 暧
蓓	费 北 备 背 卫 悲 贝 违 辈 杯 倍 呗 碑 卑 薇
柬	间 建 见 检 坚 监 减 荐 键 剑 兼 剪 艰 舰 奸
灏	好 号 劳 豪 贸 毫 耗 浩 憾 糟 帽 曹 曝 嚎 昊
忏	产 纯 炒 函 缠 倡 阐 禅 巢 蚕 馋 蝉 掺 铲 姗
黯	安 完 班 干 演 案 按 兰 暗 胆 甘 岸 俺 氨 鞍
赡	山 善 顺 占 删 闪 扇 陕 擅 衫 珊 杉 汕 姗 煽
噻	台 使 改 失 识 始 待 赛 泰 塞 栽 癌 咳 暧 饲
祀	四 司 思 死 斯 食 似 丝 私 撕 寺 肆 饲 嘶 厮
笃	都 度 读 独 顾 毒 督 杜 赌 肚 渡 堵 逾 瑜 妒
槐	华 块 怀 坏 帅 挥 慧 淮 亥 焕 卉 桓 徊 晖 痪
窘	京 讲 江 景 惊 竞 兄 穷 晶 胸 井 疆 囧 浆 颈
阙	越 确 且 却 切 曲 趣 缺 驱 裙 诀 崛 茄 靴 妾
匈	想 行 性 像 形 象 醒 箱 详 兄 姓 雄 穷 熊 胸
卯	保 慢 毛 猫 暴 贸 貌 磨 冒 矛 墨 帽 姚 庙 茅
芷	之 知 只 至 指 支 职 执 止 织 址 植 枝 芝 旨
硒	西 喜 习 息 希 戏 细 洗 悉 媳 锡 兮 隙 玺 禧
嬛	选 宣 旋 悬 暅 炫 玄 轩 萱 喧 渲 绚 璇 眩 漩
肽	太 白 台 态 哎 泰 胎 桃 陶 挨 哀 摊 抬 汰 毯
镰	建 联 连 签 练 恋 脸 链 炼 怜 剪 莲 廉 帘 敛
绛	相 两 将 京 讲 江 奖 降 娘 枪 晶 粮 疆 舰 姜
渎	都 度 读 独 顾 舞 毒 督 杜 赌 肚 渡 堵 逾 瑜
撬	表 巧 桥 乔 敲 喵 悄 瞧 雀 侨 翘 俏 窍 缪 跷
擂	类 累 陪 雷 泪 勒 蕾 磊 贼 妃 诶 嗨 蔚 昧 垒
峥	重 正 证 政 整 争 涨 征 震 郑 症 忠 挣 肿 蒸
舜	数 水 术 属 春 善 顺 甚 述 束 混 删 暑 瞬 薯
擒	气 临 庆 弃 拼 劲 琴 勤 侵 秦 寝 钦 禽 谴 妾
孚	服 付 父 富 府 附 妇 符 幅 肤 傅 抚 弗 辐 俯
铛	成 程 城 整 声 省 承 诚 盛 乘 尝 虫 撑 呈 秤
蔷	强 亲 香 乡 抢 穷 枪 墙 腔 遣 铅 呛 仟 锵 阡
泗	四 司 思 死 斯 食 似 丝 私 撕 寺 肆 饲 嘶 厮
亟	起 器 欺 骑 戚 契 漆 琪 崎 祁 麒 迄 杞 骐 憩
昼	走 周 住 州 售 洲 厚 筑 授 驻 柱 宙 舟 骤 轴
戌	需 许 续 须 苏 序 雪 虚 绪 徐 蓄 叙 旭 畜 絮
铮	重 正 证 政 整 争 涨 征 震 郑 症 忠 挣 肿 蒸
挟	些 解 谢 写 协 鞋 械 邪 谐 蟹 携 泄 歇 卸 胁
篡	原 院 选 软 寸 串 旋 贯 锻 纶 猿 惭 窜 蹿 镌
骁	小 笑 消 销 效 晓 孝 肖 萧 削 宵 潇 衔 嚣 霄
妊	人 分 本 认 任 跟 粉 闻 忍 润 仁 染 喷 愤 扔
釜	服 付 父 富 府 附 妇 符 幅 肤 傅 抚 弗 辐 俯
辕	原 院 元 远 源 园 缘 圆 怨 援 袁 苑 冤 渊 媛
捻	年 片 南 边 念 偏 填 仙 莲 殿 纤 遣 铅 碱 敛
锚	毛 猫 贸 貌 冒 矛 咬 帽 捞 姚 佬 茅 冇 茂 灶
坯	批 皮 屁 脾 疲 匹 披 劈 僻 譬 癖 痞 琵 毗 媲
霹	批 皮 屁 脾 疲 匹 披 劈 僻 譬 癖 痞 琵 毗 媲
疡	样 养 阳 杨 央 洋 扬 羊 仰 氧 旸 痒 磅 烊 秧
轶	依 异 遗 亦 姨 翼 乙 抑 逸 疫 毅 溢 奕 夷 弈
烩	回 惠 汇 慧 悔 辉 徽 毁 恢 贿 讳 卉 晖 晦 荟
甥	生 证 神 声 省 承 争 升 征 尚 胜 圣 剩 呈 昇
伎	己 机 几 系 计 及 技 集 即 纪 继 鸡 剂 寂 挤
瞿	去 区 取 句 曲 趣 距 幅 趋 驱 屈 渠 叙 愈 娶
炽	吃 此 持 迟 池 尺 赤 痴 驰 齿 耻 斥 侈 翅 睬
拗	究 您 努 牛 逆 怒 柳 纽 扭 浏 妞 绣 捏 瘤 玖
屹	依 异 遗 亦 姨 翼 乙 抑 逸 疫 毅 溢 奕 夷 弈
螂	浪 朗 汤 荡 览 邦 懒 狼 郎 廊 澜 菱 磅 琅 梆
莘	身 神 深 称 申 审 甚 沈 伸 慎 肾 渗 汕 绅 婶
朕	真 镇 针 珍 圳 阵 诊 振 侦 贞 甄 枕 帧 疹 臻
懿	依 异 遗 亦 姨 翼 乙 抑 逸 疫 毅 溢 奕 夷 弈
穹	情 请 强 清 青 轻 雄 穷 熊 倾 墙 琼 氢 汹 窘
娠	身 神 深 申 审 甚 沈 伸 慎 肾 渗 汕 绅 婶 赡
雳	理 里 力 利 历 励 厘 璃 哩 荔 吏 篱 鲤 俐 俪
沓	他 她 图 它 达 塔 踏 瓦 鸭 叭 爬 塌 祂 惕 咔
遁	单 短 村 顿 旦 盾 躲 敦 吨 吞 蹲 囤 炖 郡 钝
啬	特 格 科 设 何 歌 色 斯 呵 萨 寺 瑟 涩 肆 磕
诬	五 无 务 午 武 舞 误 屋 悟 雾 呜 勿 吾 巫 坞
琶	普 亚 怕 扒 爬 腊 披 泼 祂 啪 葩 帕 哑 靶 鸦
钗	产 才 超 察 朝 拆 赤 蔡 痴 齿 柴 揣 岔 掺 斋
貂	交 笑 销 料 角 掉 吊 屌 雕 肖 萧 钓 侨 嚼 滇
榕	容 融 痛 拥 松 荣 笼 佣 匆 蓉 绒 溶 桐 壤 熔
禀	请 并 病 冰 兵 屏 凌 饼 丙 泵 钉 秉 柄 濒 炳
仨	思 赛 爸 呀 散 罚 塔 撒 萨 纱 撕 瓦 洒 噶 伞
馍	模 默 魔 末 摩 莫 磨 摸 膜 墨 陌 脉 寞 抹 漠
睇	地 第 低 底 弟 递 帝 滴 迪 抵 敌 堤 笛 旳 缔
铎	多 堆 拖 扩 洛 措 夺 朵 哆 躲 堕 妒 琢 魄 剁
煜	于 语 育 誉 愉 郁 羽 愚 狱 愈 寓 俞 吁 钰 禺
槿	紧 庆 弃 琴 勤 侵 秦 寝 钦 禽 妾 沁 荫 黔 芹
豉	什 实 师 试 世 视 式 使 失 识 示 士 适 饰 狮
汐	西 喜 习 息 希 戏 细 洗 悉 媳 锡 兮 隙 玺 禧
噱	学 解 续 血 询 雪 阅 鞋 讯 蓄 巡 泄 叙 岳 歇
嚯	活 或 货 火 获 伙 拖 魂 扩 桌 惑 霍 祸 豁 昊
甬	用 永 拥 勇 洋 虹 庸 泳 涌 讼 佣 咏 弓 雍 秧
冗	容 共 融 童 拥 松 荣 浓 笼 佣 匆 蓉 绒 溶 桐
町	天 团 千 简 田 填 甜 添 舔 帘 掂 碱 敛 癫 黏
摹	模 默 魔 末 摩 莫 磨 摸 膜 墨 陌 脉 寞 抹 漠
鹊	越 确 却 切 绝 曲 趣 缺 驱 屈 裙 诀 崛 茄 靴
宥	有 又 游 由 优 油 右 邮 尤 幼 忧 幽 犹 诱 呦
腮	台 使 改 失 识 始 待 赛 泰 塞 栽 癌 咳 暧 饲
颊	家 加 价 假 角 佳 架 驾 甲 嘉 嫁 夹 贾 迦 钾
赂	录 绿 鲁 鹿 炉 卢 芦 璐 卤 庐 禄 噜 泸 虏 麓
瞥	谢 节 写 界 列 协 批 贴 械 贫 窃 斜 啤 咧 撇
栩	需 许 续 须 苏 序 雪 虚 绪 徐 蓄 叙 旭 畜 絮
泷	总 龙 宫 宋 隆 葱 笼 诵 垄 拢 珑 聋 胧 陇 咙
跤	教 交 校 较 叫 角 缴 焦 胶 娇 骄 郊 矫 搅 蕉
楞	灵 浪 嗡 登 冷 蒙 冯 扔 孟 蓬 耿 懵 膨 愣 棱
犊	都 度 读 独 顾 舞 毒 督 杜 赌 肚 渡 堵 逾 瑜
跆	太 白 台 态 探 哎 泰 胎 桃 陶 挨 哀 摊 抬 汰
筐	光 况 狂 宽 矿 逛 荒 框 凰 慌 煌 扛 恍 旷 匡
缭	消 销 料 聊 疗 漂 炼 娇 吊 辽 肖 郊 撩 饺 寥
酪	老 号 络 劳 疗 草 邀 逃 洛 熬 牢 捞 姥 佬 幺
谩	满 范 慢 漫 兰 贸 蛮 曼 番 炎 埋 迈 滥 婉 衍
弛	什 实 师 试 世 视 式 使 失 识 示 士 适 饰 狮
兀	五 无 务 午 武 舞 误 屋 污 悟 雾 呜 勿 吾 巫
榻	他 她 图 妈 它 达 塔 踏 瓦 鸭 叭 爬 塌 祂 惕
悸	己 机 几 系 计 及 技 集 即 纪 继 鸡 剂 寂 挤
岐	期 七 气 器 妻 旗 戚 棋 凄 祁 麒 迄 杞 祺 亟
痣	之 知 只 至 指 支 职 执 止 织 址 植 枝 芝 旨
蒽	文 而 根 温 恩 耳 恨 氛 狠 吻 韧 噩 焚 汾 焖
隽	军 均 伦 混 君 俊 允 锦 菌 逊 裙 勋 骏 峻 芸
茸	容 融 童 拥 松 荣 浓 笼 佣 匆 蓉 绒 溶 桐 壤
讥	己 机 几 系 计 级 及 技 集 即 纪 继 鸡 剂 寂
瓢	销 票 偏 漂 焦 尿 乔 抛 朴 飘 瞧 饺 嫖 瞄 蝙
痪	欢 管 源 换 环 惯 幻 患 缓 唤 喘 娟 蒜 诠 焕
槟	请 并 病 冰 兵 龄 屏 凌 饼 丙 泵 钉 秉 冥 柄
辗	展 站 战 占 珍 粘 胀 撼 兆 擅 颤 詹 沾 斩 湛
翱	博 早 案 造 奥 澳 傲 熬 凹 瑶 敖 嗷 袄 艹 蘑
厥	觉 决 绝 拘 菌 掘 爵 诀 崛 抉 倔 獗 珏 梏 蹶
濮	普 铺 吐 辅 污 谱 扑 浦 赋 葡 菩 埔 仆 蒲 噗
谚	验 延 炎 燕 盐 沿 岩 掩 宴 咽 衍 彦 妍 腌 堰
屉	体 题 提 毕 替 梯 踢 剔 屄 蚁 惕 蹄 涕 剃 嚏
怅	长 场 常 唱 厂 偿 昌 尝 畅 帐 杭 丈 肠 胀 倡
颅	路 录 陆 绿 鲁 鹿 炉 卢 芦 璐 卤 庐 禄 噜 泸
庵	安 完 班 干 演 案 按 兰 暗 蛮 胆 甘 岸 俺 氨
碉	交 笑 料 角 掉 吊 屌 雕 肖 萧 淀 钓 翘 滇 霄
顷	情 请 清 星 亲 青 轻 庆 倾 勤 睛 晴 卿 菱 擎
紊	文 问 微 温 卫 粉 闻 稳 纷 纹 吻 畏 挽 丸 雯
榭	些 谢 写 协 鞋 械 邪 谐 蟹 携 泄 蝎 歇 卸 胁
阑	担 络 兰 蓝 览 烂 懒 篮 栏 滥 谭 衍 旱 拦 澜
搀	产 差 潮 缠 趁 倡 阐 禅 巢 馋 蝉 掺 铲 瀚 忏
锵	相 两 强 响 庆 抢 梁 凉 枪 墙 谅 腔 遣 铅 呛
曳	也 业 夜 爷 野 页 叶 娱 隔 液 耶 椰 冶 噎 烨
阖	和 合 呢 设 何 则 呵 河 核 喝 虎 盒 荷 吓 赫
窒	之 知 只 至 指 支 职 执 止 织 址 植 枝 芝 旨
卟	不 部 步 补 布 趣 波 族 捕 屈 怖 卜 埠 凸 醋
遐	下 西 喜 消 夏 侠 瞎 霞 萧 虾 辖 峡 狭 屑 暇
瞌	可 科 客 课 克 刻 颗 吓 渴 壳 柯 磕 棵 厄 苛
恁	文 问 怎 呢 份 粉 闻 仁 氛 狠 愤 吻 嫩 啃 饪
箫	小 笑 消 销 效 晓 孝 霞 肖 萧 削 宵 潇 侨 嚣
踹	坏 川 帅 船 吹 拆 衰 柴 垂 摔 甩 淮 喘 揣 拽
羲	西 喜 习 息 希 戏 细 洗 悉 媳 夕 锡 兮 隙 玺
瑚	户 护 乎 湖 呼 胡 虎 忽 糊 狐 沪 壶 蝴 葫 弧
礴	报 博 播 波 摩 伯 拨 墨 堡 玻 寞 勃 搏 泊 驳
摒	请 并 病 冰 兵 龄 屏 凌 饼 丙 泵 钉 秉 冥 柄
熠	依 遗 亦 姨 翼 乙 抑 逸 疫 毅 溢 奕 夷 弈 祎
琥	户 护 乎 湖 呼 胡 虎 忽 糊 狐 沪 壶 蝴 葫 弧
磋	错 获 弱 措 惑 夺 挫 裹 翠 豁 醋 嗦 搓 璀 厝
焙	费 北 备 背 卫 悲 贝 雷 违 辈 杯 倍 呗 碑 卑
荼	图 股 步 土 突 顾 途 偷 玉 俗 吐 徒 兔 涂 妥
踊	用 东 功 永 拥 勇 庸 泳 涌 佣 咏 雍 烊 珑 聋
廿	年 片 南 边 念 偏 填 仙 莲 殿 纤 遣 铅 碱 敛
噔	当 等 登 灯 仍 碰 邓 崩 彭 橙 澄 蹭 盯 耿 懵
恪	可 科 客 课 克 刻 颗 俄 渴 壳 柯 磕 棵 厄 苛
殡	音 近 边 版 遍 避 欣 宾 滨 饼 辨 谨 斌 彬 尹
珞	理 里 力 利 历 励 厉 厘 璃 哩 荔 吏 篱 鲤 俐
濡	如 入 母 故 诉 遇 孤 虎 予 乳 狱 腹 雾 辱 儒
剿	教 交 校 较 叫 角 脚 缴 焦 胶 娇 骄 郊 矫 搅
矗	出 吃 处 初 除 楚 础 触 储 筹 厨 酬 蔬 丶 橱
缇	体 题 提 毕 替 梯 踢 剔 裔 惕 蹄 涕 剃 嚏 啼
抨	等 更 朋 曾 登 灯 聘 碰 萌 崩 盆 捧 鹏 扔 彭
钵	报 博 播 波 伯 拨 墨 堡 玻 寞 勃 搏 泊 驳 脖
矜	气 临 庆 弃 劲 琴 勤 侵 秦 寝 钦 禽 谴 妾 怯
鱿	有 友 又 游 由 优 油 右 邮 尤 幼 忧 幽 犹 诱
寰	欢 管 源 换 环 惯 幻 患 缓 唤 喘 娟 蒜 诠 焕
邃	失 识 始 随 岁 虽 碎 髓 嗦 贿 溯 遂 隧 穗 隋
骼	个 格 歌 各 根 哥 革 隔 割 戈 葛 鸽 阁 搁 辜
奚	西 喜 习 息 希 戏 细 洗 悉 媳 夕 锡 兮 隙 玺
隅	于 语 育 誉 愉 郁 羽 愚 狱 愈 寓 俞 吁 钰 禺
眩	选 宣 旋 悬 暅 炫 玄 轩 萱 喧 渲 绚 璇 嬛 漩
寐	没 美 内 每 非 妹 媒 辈 梅 煤 魅 眉 玫 霉 枚
胰	依 遗 亦 姨 翼 乙 抑 逸 疫 毅 溢 奕 夷 弈 祎
腋	也 业 夜 爷 野 页 叶 宇 欲 娱 隔 液 耶 椰 冶
唏	西 喜 习 息 希 吸 惜 媳 晰 夕 兮 茜 隙 玺 烯
鳌	早 案 造 奥 澳 傲 熬 凹 瑶 豹 敖 嗷 袄 艹 蘑
粱	两 量 讲 亮 练 恋 奖 灵 良 朗 辆 梁 凉 粮 祥
鹦	应 影 英 营 迎 硬 映 赢 盈 颖 婴 鹰 樱 荧 蝇
沏	期 七 气 妻 戚 棋 凄 祁 麒 迄 杞 祺 亟 岐 骐
璋	长 张 终 章 航 掌 账 涨 障 尝 帐 丈 肿 胀 仗
淼	教 交 描 妙 鸟 秒 苗 骄 喵 庙 饺 渺 寥 嫖 婊
诏	号 找 展 照 招 赵 桌 遭 召 吵 耗 扎 兆 罩 昭
裘	求 球 救 秋 琴 仇 丘 钮 邱 蛆 琦 凄 囚 糗 酋
枷	家 加 价 假 佳 架 驾 甲 嘉 嫁 夹 贾 煎 迦 钾
岑	怎 村 侧 纷 寸 愤 辰 臣 嫩 韧 壬 粪 啃 璨 摁
稼	家 加 价 假 佳 架 驾 甲 嘉 嫁 夹 贾 煎 迦 钾
晌	上 场 常 商 张 声 唱 省 伤 厂 尚 胜 赏 帐 杭
粕	破 婆 波 莫 霸 拨 沃 坡 颇 泼 葩 剖 耙 劈 珀
诙	回 惠 汇 挥 慧 悔 辉 徽 毁 恢 贿 讳 卉 晖 晦
婧	经 精 境 景 竟 竞 镜 净 敬 睛 径 晶 颈 殑 荆
珉	文 问 微 温 卫 粉 闻 稳 纷 纹 吻 畏 挽 丸 雯
酋	求 球 救 秋 仇 丘 寝 钮 邱 琦 凄 囚 臼 糗 遛
邺	也 业 夜 爷 野 页 叶 欲 娱 隔 液 耶 椰 冶 噎
峪	于 语 育 誉 愉 郁 羽 愚 狱 愈 寓 俞 吁 钰 禺
嗤	吃 此 持 迟 池 尺 赤 痴 驰 齿 耻 斥 侈 翅 睬
猝	趣 顾 族 舞 鱼 促 粗 崔 逾 瑜 凸 醋 妒 吾 舆
幌	黄 皇 爽 荒 凰 谎 慌 煌 晃 恍 桓 惶 簧 潢 徨
湄	没 美 内 每 非 妹 迷 媒 辈 梅 煤 魅 眉 玫 霉
鹉	五 无 务 物 午 武 舞 误 吴 屋 悟 乌 伍 雾 呜
歆	心 新 信 希 吸 欣 辛 薪 斤 逊 芯 筋 辖 鑫 腥
舀	要 约 脑 药 摇 邀 腰 妖 耀 遥 咬 谣 岆 瑶 姚
峙	什 实 师 试 世 视 式 使 失 识 示 士 适 饰 狮
蔗	这 着 者 折 喆 哲 浙 遮 柱 汁 煮 殖 辙 褶 辄
黍	书 术 熟 束 树 舒 殊 暑 鼠 疏 蔬 抒 赎 薯 墅
枭	小 笑 消 销 效 晓 孝 霞 肖 萧 削 宵 潇 侨 嚣
轼	什 实 师 试 世 视 式 使 失 识 示 士 适 饰 狮
劢	买 白 台 改 卖 哎 麦 挨 眉 哀 玫 栽 迈 狸 霾
庶	书 术 熟 束 树 舒 殊 暑 鼠 疏 蔬 抒 赎 薯 墅
诲	惠 汇 挥 慧 灰 悔 辉 徽 毁 绘 恢 贿 讳 卉 晖
炅	更 攻 仍 碰 猛 逢 杠 耕 梗 庚 蓬 缸 弓 耿 憎
笠	理 里 力 利 历 励 厉 厘 璃 哩 荔 吏 篱 鲤 俐
狈	费 北 备 背 卫 悲 贝 违 辈 杯 倍 呗 碑 卑 薇
褚	出 吃 处 初 除 楚 础 触 储 筹 厨 酬 丶 橱 雏
戎	让 容 供 控 融 荣 扔 轰 蓉 绒 溶 弓 嵩 熔 榕
怦	朋 曾 登 灯 聘 碰 萌 崩 捧 鹏 扔 彭 棚 蓬 膨
呻	身 神 深 称 申 审 甚 沈 伸 慎 肾 渗 汕 绅 婶
栀	之 知 只 至 指 支 职 执 止 织 址 植 枝 芝 旨
痔	之 知 只 至 指 支 职 执 止 织 址 植 枝 芝 旨
涟	建 联 连 签 练 恋 脸 链 炼 粮 怜 剪 莲 廉 帘
蛀	主 住 助 筑 猪 逐 珠 朱 诸 竹 驻 柱 丶 烛 株
忱	称 陈 沉 珍 晨 彻 撤 阵 尘 辰 臣 痕 趁 衬 唇
嫡	地 第 低 底 弟 递 帝 滴 迪 抵 敌 蒂 堤 笛 旳
迥	经 将 京 惊 竞 雄 穷 熊 疆 姜 酱 囧 浆 璟 鲸
喳	注 查 插 咋 召 扎 炸 渣 诈 詹 挚 闸 榨 眨 乍
琛	称 陈 沉 珍 晨 彻 撤 阵 尘 辰 臣 痕 趁 衬 唇
陨	员 运 言 云 孕 允 晕 韵 蕴 匀 芸 酝 耘 昀 熨
夯	放 王 航 账 畅 横 绑 杭 哼 谎 氧 鸿 磅 杖 倘
祟	失 识 始 随 岁 虽 损 碎 髓 嗦 贿 溯 遂 隧 穗
猬	未 维 卫 谓 伟 危 违 胃 薇 韦 畏 潍 纬 猥 萎
髅	又 路 头 楼 否 录 露 豆 陆 搜 透 漏 炉 喽 苟
涮	算 换 环 刷 川 赚 缓 闪 摔 甩 霜 擅 汕 煽 栓
嗲	打 店 答 假 弟 佳 驾 搭 帝 跌 敌 嫁 雕 扂 碟
撂	连 销 料 聊 疗 漂 炼 娇 吊 辽 肖 郊 撩 饺 寥
岱	代 海 孩 带 待 材 嘚 贷 莱 戴 呆 袋 歪 歹 黛
阡	前 钱 千 签 潜 迁 欠 牵 谦 遣 铅 乾 倩 谴 黔
酣	战 般 汉 韩 含 寒 涵 喊 汗 憾 函 撼 旱 晗 焊
浚	训 询 寻 讯 迅 循 悬 巡 逊 旬 勋 熏 绚 驯 衅
偎	未 维 卫 谓 伟 危 违 胃 薇 韦 畏 潍 纬 猥 萎
斟	真 镇 针 珍 圳 阵 诊 振 侦 贞 甄 枕 帧 疹 臻
卞	变 先 见 边 编 遍 辩 滨 莲 辨 贬 鞭 帘 黏 缅
邰	太 台 态 败 哎 泰 胎 桃 挨 哀 癌 抬 汰 亥 毯
芮	若 罪 弱 瑞 绘 乳 恢 催 锐 怼 睿 髓 贿 遂 秽
潦	连 销 料 聊 疗 漂 炼 娇 吊 辽 肖 郊 撩 饺 寥
袒	谈 范 弹 探 坛 坦 摊 贪 叹 碳 滩 炭 吞 谭 潭
骷	苦 突 趣 族 库 哭 酷 裤 枯 旭 敷 逾 瑜 芦 窟
喋	注 查 插 咋 召 扎 炸 渣 诈 詹 挚 闸 榨 眨 乍
邸	地 第 低 底 弟 递 帝 滴 迪 抵 敌 蒂 堤 笛 旳
枸	友 候 又 够 购 构 狗 沟 谷 勾 雇 钩 苟 逅 垢
莴	我 播 握 佛 魔 卧 窝 沃 陌 脉 涡 伍 玻 喔 倭
跷	表 缴 巧 桥 乔 敲 悄 瞧 雀 侨 翘 俏 掐 窍 缪
揖	依 遗 亦 姨 翼 乙 抑 逸 疫 毅 溢 奕 弈 祎 裔
攸	有 又 游 由 优 油 右 邮 尤 幼 忧 幽 诱 呦 佑
邋	马 历 离 拉 啦 垃 辣 塌 叻 梨 蜡 腊 喇 锕 耙
芈	极 米 密 迷 既 秘 蜜 弥 咪 谜 幂 裔 泌 靡 觅
咫	之 知 只 至 指 支 职 执 止 织 址 植 枝 芝 旨
琵	皮 屁 脾 疲 匹 披 啤 劈 僻 譬 癖 痞 霹 毗 媲
迂	于 语 育 誉 愉 郁 羽 愚 狱 愈 寓 俞 吁 钰 禺
汛	婚 训 询 寻 讯 迅 循 巡 逊 旬 勋 沦 熏 驯 薰
龌	我 播 握 佛 魔 卧 窝 沃 陌 脉 涡 伍 玻 喔 倭
迸	并 仍 碰 萌 衡 凤 崩 猛 彭 蚌 蹦 泵 耿 柄 懵
豌	完 万 玩 晚 湾 弯 碗 挽 塆 丸 婉 顽 腕 宛 檀
晤	五 无 物 舞 吴 悟 伍 呜 勿 吾 巫 唔 坞 梧 捂
羚	零 领 另 灵 令 龄 凌 玲 铃 陵 岭 菱 聆 伶 拎
戮	录 陆 绿 鲁 鹿 炉 卢 芦 璐 卤 庐 禄 噜 泸 虏
吆	要 约 药 摇 邀 腰 妖 耀 遥 咬 谣 岆 瑶 丫 姚
戊	五 无 物 舞 吴 悟 伍 呜 勿 吾 巫 唔 坞 梧 捂
锰	等 更 梦 盟 蒙 疯 萌 猛 孟 泵 蹭 懵 绷 凳 瞪
腱	件 建 简 检 坚 监 剑 鉴 艰 舰 奸 箭 煎 捡 牋
纫	人 认 任 份 忍 奔 仁 染 喷 吻 苯 韧 壬 刃 恳
蜻	情 请 清 英 亲 青 轻 庆 倾 勤 睛 晴 坪 卿 菱
佚	依 遗 亦 姨 翼 乙 抑 逸 疫 毅 溢 奕 弈 祎 裔
蜓	听 星 英 统 亲 领 形 挺 停 庭 厅 映 疼 婷 亭
俑	用 永 拥 勇 庸 泳 鸿 涌 筒 佣 咏 雍 聋 秧 甬
骸	还 百 海 孩 载 牌 害 彩 赛 奶 汇 耐 摆 挨 寨
宸	称 陈 沉 镇 晨 沈 撑 尘 辰 臣 痕 趁 蠢 衬 唇
峭	表 缴 巧 桥 乔 敲 悄 瞧 雀 侨 翘 俏 掐 窍 缪
咆	靠 毛 婆 跑 劳 抱 派 草 爆 判 泡 炮 抛 豹 枣
崴	外 待 卖 态 载 牌 财 排 拍 维 害 歪 挽 慨 蔚
腆	天 团 限 简 田 填 甜 添 舔 帘 掂 碱 敛 癫 黏
啫	这 着 者 致 折 喆 哲 浙 遮 煮 吱 辙 褶 辄 蔗
烷	完 万 玩 晚 湾 挖 弯 碗 挽 塆 丸 婉 顽 腕 宛
仄	客 课 则 责 紫 液 泽 磕 冶 棵 褐 啧 厄 苛 孜
霏	美 费 非 飞 肥 菲 废 啡 肺 妃 匪 沸 绯 翡 斐
潼	同 通 总 统 痛 童 铜 筒 桶 婷 佣 匆 桐 彤 瞳
咄	多 堆 盾 盗 拖 扩 洛 措 夺 朵 哆 躲 堕 妒 琢
羔	高 告 搞 貌 毫 泡 澳 冒 郭 傲 甘 稿 糕 膏 镐
阪	办 班 研 版 晚 眼 半 般 板 伴 棒 搬 颁 斑 扮
圃	普 促 距 铺 吐 辅 污 谱 悟 驱 扑 浦 葡 菩 埔
洙	主 住 助 祝 筑 猪 逐 珠 竹 驻 柱 煮 丶 烛 株
俨	验 严 延 炎 燕 盐 沿 岩 掩 宴 咽 衍 彦 妍 腌
昀	员 运 云 孕 允 晕 韵 蕴 匀 熏 媛 芸 酝 耘 陨
衢	去 区 取 诉 曲 趣 促 幅 趋 驱 屈 渠 娶 躯 佢
蹋	他 她 图 它 达 塔 踏 瓦 鸭 叭 爬 塌 祂 惕 咔
戾	理 里 力 利 历 励 厉 厘 璃 哩 荔 吏 篱 鲤 俐
郴	络 兰 蓝 览 烂 懒 篮 栏 滥 谭 拦 翰 澜 揽 缆
蹊	其 期 七 气 器 妻 戚 棋 凄 祁 麒 迄 杞 祺 亟
骋	成 程 城 充 声 承 诚 盛 乘 撑 呈 肠 秤 惩 敞
蘸	展 站 战 占 珍 粘 胀 撼 兆 擅 颤 詹 沾 斩 湛
砚	验 严 延 炎 燕 盐 沿 岩 掩 宴 咽 衍 彦 妍 腌
遢	他 她 图 它 达 塔 踏 瓦 鸭 叭 爬 塌 祂 惕 咔
浣	欢 款 换 环 惯 幻 患 缓 唤 喘 娟 蒜 悍 憨 媛
诟	友 候 又 够 购 构 狗 沟 谷 勾 雇 钩 苟 逅 垢
椿	产 春 楚 纯 础 沉 尘 缠 趁 蠢 唇 锤 戳 醇 掺
鸳	原 院 元 远 源 园 缘 圆 怨 援 袁 苑 冤 渊 媛
浜	让 并 放 房 望 帮 党 忙 榜 棒 邦 绑 杭 斑 仰
砰	朋 峰 碰 捧 鹏 彭 棚 蓬 耿 膨 僧 澎 乓 烹 憎
吩	分 认 份 肯 温 粉 奋 纷 繁 凤 森 锋 氛 愤 芬
阉	验 严 延 炎 燕 盐 沿 岩 掩 宴 咽 衍 彦 妍 腌
泯	民 命 敏 蛮 秦 邻 淫 绵 殷 闽 濒 旻 闵 悯 冕
偕	些 解 谢 写 协 鞋 械 邪 谐 蟹 携 泄 蝎 歇 卸
羌	相 强 亲 香 庆 乡 抢 穷 梁 枪 墙 腔 遣 铅 呛
殃	样 营 养 阳 杨 央 洋 扬 羊 仰 氧 旸 痒 磅 烊
褥	如 入 故 诉 付 孤 吴 虎 予 乳 狱 腹 雾 辱 儒
踝	话 化 花 华 婚 画 划 坏 虎 挥 滑 辉 缓 夸 昏
龊	错 获 楚 纯 炒 惑 吵 挫 豁 戳 雏 淳 烁 辍 绰
蟑	长 张 站 章 钟 掌 账 涨 障 忠 帐 丈 胀 仗 彰
獒	博 早 案 造 奥 澳 傲 熬 凹 瑶 敖 嗷 袄 艹 蘑
祯	长 正 证 政 城 整 终 争 征 震 郑 症 挣 蒸 拯
馁	内 未 配 黑 维 飞 味 培 围 拟 萎 玮 镁 翡 炜
毗	被 皮 屁 脾 疲 匹 披 劈 僻 譬 痞 坯 霹 琵 媲
胤	因 音 银 引 印 阴 隐 饮 姻 乙 淫 瘾 吟 殷 尹
锛	本 班 备 闻 奔 倍 纷 宾 搬 笨 氛 狠 苯 瓣 韧
诣	艺 依 忆 遗 亦 姨 翼 乙 抑 逸 疫 毅 溢 蛾 奕
馥	服 付 父 富 府 附 妇 符 幅 肤 傅 抚 弗 辐 俯
骰	头 图 由 优 投 透 偷 尤 厚 沟 徒 犹 兜 酉 喉
芊	前 钱 千 签 潜 迁 牵 歉 谦 遣 铅 乾 倩 嵌 黔
篆	专 转 传 换 穿 状 川 赚 船 钻 撞 串 砖 唤 粘
燎	消 销 料 聊 疗 漂 炼 吊 孝 辽 肖 郊 撩 饺 寥
漩	选 宣 旋 悬 暅 炫 玄 轩 萱 喧 渲 绚 璇 嬛 眩
腼	面 免 恋 渐 献 眠 苗 棉 淀 绵 勉 乾 癫 缅 俭
鹭	录 绿 鲁 鹿 炉 卢 碌 芦 璐 卤 庐 禄 噜 泸 虏
彝	艺 依 忆 遗 亦 姨 翼 乙 抑 逸 疫 毅 溢 蛾 奕
炕	让 康 堂 档 扬 抗 狼 芳 脏 囊 塘 葬 冈 扛 秧
弩	努 突 趣 顾 族 舞 鱼 木 苏 怒 妮 奴 尉 穆 畜
媲	被 皮 屁 脾 疲 匹 披 劈 僻 譬 痞 坯 霹 琵 毗
楂	查 咋 召 扎 炸 渣 诈 詹 挚 闸 榨 眨 乍 诧 栅
擞	友 候 游 购 构 搜 舒 幽 犹 肃 疏 呦 赎 墅 嗽
砷	身 神 深 称 申 审 甚 沈 尘 伸 慎 肾 渗 汕 绅
叩	友 候 口 构 某 苦 扣 幼 奏 呦 吼 枯 抠 逅 嗽
娩	面 免 恋 渐 献 眠 苗 棉 淀 绵 勉 乾 癫 缅 俭
惆	出 后 手 处 州 抽 厚 丑 筹 厨 臭 酬 愁 猴 宙
鸯	样 营 养 阳 杨 央 洋 扬 羊 仰 氧 旸 痒 烊 秧
妩	五 无 物 午 武 舞 吴 悟 乌 伍 呜 勿 吾 巫 唔
睾	高 告 搞 貌 泡 澳 冒 郭 傲 甘 稿 糕 膏 镐 皋
箴	真 镇 针 珍 圳 阵 诊 振 侦 贞 甄 枕 帧 疹 臻
磺	黄 床 皇 荒 凰 谎 慌 煌 晃 恍 桓 惶 簧 潢 徨
滁	出 吃 处 初 除 楚 础 触 储 筹 池 厨 酬 蔬 丶
迢	表 校 调 条 笑 聊 跳 挑 妙 屌 椒 喵 蕉 韬 啸
萦	应 影 英 营 迎 硬 映 赢 颖 鹰 樱 荧 蝇 萤 嘤
贮	主 住 助 祝 筑 猪 逐 珠 竹 驻 柱 煮 丶 烛 株
脯	普 欲 促 铺 吐 辅 污 谱 悟 扑 浦 葡 菩 埔 仆
擀	感 万 干 饭 敢 赶 残 甘 艳 憾 贪 杆 肝 尴 赣
葆	保 报 号 办 包 宝 抱 爆 暴 薄 逃 饱 堡 恼 剥
熨	员 运 云 阅 孕 允 晕 韵 蕴 匀 芸 酝 耘 陨 昀
钊	号 找 展 照 招 赵 桌 遭 召 吵 耗 扎 兆 罩 昭
觑	去 区 取 诉 曲 趣 促 距 幅 姑 趋 驱 屈 渠 娶
氪	可 科 客 课 克 刻 哭 颗 渴 壳 柯 磕 棵 厄 苛
翌	艺 依 忆 遗 亦 姨 翼 乙 抑 逸 疫 毅 溢 蛾 奕
芍	少 号 找 杀 绍 烧 稍 闪 召 吵 耗 纱 嫂 衫 邵
匝	再 哪 早 造 族 杂 灾 挖 拔 乏 咖 炸 押 芭 砸
饬	吃 持 至 迟 池 尺 赤 痴 驰 齿 耻 斥 侈 翅 炽
甪	录 绿 鲁 鹿 炉 卢 碌 芦 璐 卤 庐 禄 噜 泸 虏
啵	报 博 播 波 摩 伯 拨 堡 玻 卜 勃 搏 泊 驳 脖
哽	更 登 港 疯 缝 蜂 耕 梗 庚 巩 枫 翁 耿 檬 龚
猾	话 化 花 华 婚 画 划 坏 虎 挥 滑 辉 缓 夸 昏
绫	零 领 另 灵 令 龄 凌 玲 铃 陵 岭 菱 聆 伶 拎
涓	检 坚 官 监 端 圈 卷 捐 劵 倦 娟 眷 柬 嬛 篡
昙	谈 慢 弹 探 坛 坦 摊 贪 叹 碳 滩 炭 烫 谭 潭
俅	求 球 救 秋 仇 丘 寝 钮 邱 琦 凄 囚 臼 糗 遛
愫	诉 速 素 舞 苏 宿 俗 塑 傅 肃 凸 醋 妒 吾 舆
蟒	望 帮 忙 访 央 棒 洋 钢 坊 茫 盲 躺 芒 沧 妄
诩	需 许 续 须 苏 序 附 虚 绪 徐 蓄 腹 叙 旭 畜
痫	现 限 险 显 县 鲜 陷 嫌 贤 羡 咁 纤 弦 宪 咸
飚	表 变 校 标 暴 脚 飘 浇 飙 彪 婊 刁 僚 镖 枭
殉	训 询 寻 讯 迅 循 遵 巡 逊 旬 勋 沦 熏 钝 驯
癜	点 电 店 连 典 垫 歉 莲 吊 羡 颠 淀 殿 扂 巅
挞	他 她 图 它 达 塔 踏 瓦 鸭 叭 爬 塌 祂 惕 咔
愕	哦 额 恶 俄 呃 饿 噩 厄 鄂 遏 娥 讹 扼 胺 峨
搽	差 楚 察 触 茶 插 扎 莎 叉 耻 侈 蝉 岔 榨 茬
肄	艺 依 忆 遗 亦 姨 翼 乙 抑 逸 疫 毅 溢 蛾 奕
滘	教 交 校 较 叫 角 脚 缴 焦 胶 娇 骄 郊 矫 搅
诃	和 合 何 户 呵 河 核 喝 虎 涉 盒 荷 吓 赫 贺
椭	讨 索 托 脱 锁 拖 拓 桃 陶 妥 魄 挪 陀 驼 唾
腩	男 难 南 干 演 满 版 晚 弹 暖 湾 沿 函 杆 堪
撅	规 贵 归 鬼 柜 瓜 轨 跪 瑰 桂 闺 粹 龟 硅 诡
荀	许 训 询 寻 讯 迅 循 遵 巡 逊 旬 勋 沦 熏 绚
樵	千 巧 桥 乔 敲 悄 瞧 雀 侨 翘 俏 礁 掐 硝 窍
唆	所 错 坐 苏 索 锁 缩 洛 措 惑 夺 扫 霍 琐 琢
苓	零 领 另 灵 令 龄 凌 玲 铃 陵 岭 菱 聆 伶 拎
玟	文 问 微 温 粉 闻 稳 纷 纹 吻 畏 挽 丸 雯 蚊
秆	感 万 跟 干 敢 赶 残 甘 憾 杆 肝 尴 扳 赣 嫣
嗖	候 某 搜 舒 幽 犹 肃 疏 呦 搂 牟 嗽 艘 曙 髅
谙	安 完 班 干 演 案 按 暗 蛮 胆 甘 岸 俺 氨 鞍
懑	们 门 闻 蒙 敏 纷 闷 眉 玫 狠 嫩 昧 韧 蔓 酶
鹃	检 坚 官 监 端 圈 卷 捐 劵 倦 娟 眷 柬 嬛 篡
锢	股 故 古 顾 估 鼓 固 骨 孤 谷 雇 辜 菇 咕 沽
胱	管 光 广 刚 况 馆 惯 狂 钢 逛 纲 凰 谎 灌 缸
酗	需 许 续 须 苏 序 雪 附 虚 绪 徐 蓄 叙 旭 畜
绢	检 坚 官 监 端 圈 卷 捐 劵 倦 娟 眷 柬 嬛 篡
跻	己 机 计 级 及 技 集 即 纪 继 鸡 剂 寂 挤 稽
攘	让 房 望 防 党 仿 荡 邦 杭 仰 杠 壤 肪 镑 琅
烬	进 金 今 近 极 尽 仅 紧 津 禁 劲 斤 锦 谨 晋
胭	验 延 炎 燕 盐 沿 掩 宴 咽 衍 彦 腌 堰 晏 檐
掖	也 业 夜 爷 野 页 叶 娱 隔 液 耶 椰 冶 噎 烨
呷	下 西 喜 消 夏 侠 瞎 霞 萧 虾 辖 峡 狭 屑 暇
拴	算 换 环 刷 赚 缓 闪 摔 甩 霜 擅 汕 煽 栓 痪
曜	要 约 药 摇 邀 腰 妖 耀 遥 咬 谣 岆 瑶 姚 咽
踵	中 种 重 正 证 张 充 红 终 众 钟 涨 忠 宠 虹
恃	什 实 师 试 世 视 式 使 失 识 示 士 适 饰 狮
膛	庭 堂 唐 糖 汤 摊 躺 塘 趟 芒 烫 桐 棠 倘 淌
狩	手 数 收 书 受 首 售 守 授 丑 寿 兽 暑 瘦 署
捯	到 道 导 倒 岛 刀 澳 旦 冒 傲 戴 胆 盗 呆 邀
皿	进 民 敏 浸 吟 泌 闽 缅 觅 吝 寅 蔑 旻 芹 闵
弋	艺 依 遗 亦 姨 翼 乙 抑 逸 疫 毅 溢 蛾 奕 弈
稷	己 机 计 级 及 技 集 即 纪 继 鸡 剂 寂 挤 稽
嗳	爱 继 批 哎 艾 唉 碍 埃 欸 挨 哀 晰 癌 矮 暧
侏	主 住 助 祝 筑 猪 逐 珠 竹 驻 柱 煮 丶 烛 株
喏	活 脑 努 诺 锅 惑 夺 哆 堕 囖 豁 挪 懦 骆 糯
茁	主 著 桌 卓 祸 捉 丶 烛 爪 拙 灼 赘 浊 绰 酌
笆	吧 八 把 卡 爸 呀 播 巴 薄 拔 芭 罢 怖 叭 疤
秸	接 结 节 界 姐 介 街 借 截 揭 捷 戒 皆 劫 羯
衙	亚 呀 压 夜 雅 牙 罚 押 涯 鸭 丫 吖 芽 讶 哑
痊	全 权 券 幻 缘 圆 潜 迁 患 泉 劝 拳 悬 谦 锻
栾	乱 幻 缘 圆 卷 冠 链 缓 炼 览 烂 怨 泉 懒 篮
毓	于 预 遇 域 余 雨 愉 郁 愚 寓 豫 裕 逾 瑜 舆
佘	设 社 适 摄 舍 射 涉 彻 沈 氏 吓 厦 蛇 奢 舌
翎	零 领 另 灵 令 龄 凌 玲 铃 陵 岭 菱 聆 伶 拎
羿	艺 依 遗 亦 姨 翼 乙 抑 逸 疫 毅 溢 蛾 奕 弈
瓯	族 苏 湖 估 欧 偶 喽 酉 逾 瑜 喉 芦 殴 呕 鸥
岷	进 民 敏 浸 吟 彬 闽 缅 觅 吝 寅 蔑 旻 芹 闵
忡	重 场 常 程 城 充 冲 尝 聪 崇 忠 虫 宠 仲 肿
孬	男 脑 豪 诺 闹 糕 扫 妖 炮 桃 槽 恼 捞 姚 挠
嘈	包 宝 导 告 跑 劳 操 草 扰 耗 腰 矛 曹 冇 茂
癣	选 宣 旋 悬 暅 炫 玄 轩 萱 喧 渲 绚 璇 嬛 眩
淞	红 共 送 供 融 松 宋 踪 讼 轰 诵 颂 嵩 怂 耸
簸	博 播 波 伯 拨 堡 玻 卜 寞 勃 搏 泊 驳 脖 渤
溉	该 孩 改 牌 财 排 概 菜 盖 泰 鬼 奈 埃 抬 尬
掇	多 读 货 队 夺 朵 哆 躲 萝 堕 裹 稻 捣 剁 惰
搪	庭 堂 唐 糖 汤 摊 躺 塘 趟 烫 桐 棠 倘 谤 淌
匾	变 先 见 边 编 遍 搬 辩 滨 莲 辨 贬 鞭 帘 黏
螨	满 谈 范 慢 漫 贸 蛮 曼 番 埋 迈 肝 滥 婉 谭
苷	感 万 跟 干 敢 赶 残 甘 憾 杆 肝 尴 扳 赣 嫣
裱	表 变 校 标 暴 脚 秒 飘 浇 飙 彪 婊 刁 僚 镖
泱	样 眼 养 阳 杨 央 洋 扬 羊 仰 氧 旸 痒 磅 烊
徙	西 喜 息 希 吸 惜 媳 晰 夕 兮 茜 隙 玺 烯 嬉
谔	哦 额 恶 俄 呃 饿 噩 厄 鄂 遏 娥 讹 扼 胺 峨
慵	用 永 拥 迎 勇 盈 庸 泳 涌 葱 轰 佣 咏 雍 甬
孢	保 报 包 宝 抱 爆 暴 薄 邀 逃 饱 堡 遥 恼 剥
嫦	长 场 常 唱 厂 偿 昌 尝 畅 帐 丈 肠 倡 敞 疮
磐	盘 判 残 胖 栏 艳 燕 坎 尴 盼 潘 叛 攀 晗 帕
胥	需 许 续 须 苏 序 雪 附 虚 绪 徐 蓄 叙 旭 畜
熹	西 喜 息 希 吸 惜 媳 晰 夕 兮 茜 隙 玺 烯 嬉
缜	真 镇 针 珍 圳 阵 诊 振 侦 贞 甄 枕 帧 疹 臻
闰	员 入 认 寻 润 滚 俊 辱 敦 棍 吞 蕴 茹 峻 妊
悴	随 鬼 嘴 醉 磁 催 脆 挫 驰 齿 粹 翠 崔 锤 咀
瑙	男 脑 豪 诺 闹 糕 扫 妖 炮 桃 槽 恼 捞 姚 挠
涝	老 料 络 搞 倒 劳 疗 草 牢 捞 囖 姥 佬 茂 昊
睢	使 失 识 始 死 随 岁 虽 碎 髓 嗦 贿 溯 遂 隧
贻	艺 依 遗 亦 姨 翼 乙 抑 逸 疫 毅 溢 蛾 奕 弈
憔	巧 桥 乔 敲 喵 悄 瞧 雀 嵌 侨 翘 俏 掐 硝 窍
爻	要 约 套 药 摇 邀 腰 妖 耀 遥 咬 谣 岆 瑶 姚
筠	员 运 言 云 孕 允 晕 韵 蕴 匀 芸 酝 耘 陨 昀
丿	谢 节 写 界 列 协 批 贴 械 贫 窃 斜 啤 咧 撇
缈	教 交 跳 描 妙 鸟 秒 苗 骄 喵 悄 庙 饺 渺 嫖
漪	意 已 义 医 移 仪 伊 谊 疫 毅 椅 溢 怡 祎 颐
竺	主 住 助 祝 筑 猪 逐 珠 竹 驻 柱 煮 丶 烛 株
飒	把 它 达 阿 斯 咯 踏 塞 撒 萨 扒 洒 葩 阀 涩
镍	结 姐 届 杰 烈 截 捷 灭 邪 妮 憋 捏 孽 聂 邂
札	查 插 猪 咋 召 扎 炸 渣 诈 柱 詹 挚 闸 榨 眨
缥	表 票 效 料 挑 漂 焦 妙 朴 飘 瞧 郊 扁 嫖 凋
涧	件 建 简 检 坚 监 剑 兼 鉴 艰 舰 奸 箭 煎 捡
抿	民 敏 淫 浸 吟 殷 泌 闽 缅 觅 吝 蔑 旻 芹 闵
嫔	品 银 您 评 频 拼 贫 琳 淫 巾 盆 闵 悯 鳞 忻
吠	费 非 飞 肥 菲 废 啡 胃 肺 妃 匪 沸 绯 猥 镁
戟	己 机 集 击 激 吉 辑 既 寂 忌 稽 饥 姬 嫉 脊
鲫	己 机 集 击 激 吉 辑 既 寂 忌 稽 饥 姬 嫉 脊
龈	因 音 银 引 印 阴 隐 饮 姻 淫 瘾 吟 殷 尹 茵
挎	话 化 快 困 咯 跨 滑 亏 扩 瓜 夸 阔 哗 葵 垮
薏	意 已 义 医 移 仪 伊 谊 疫 毅 椅 溢 怡 祎 颐
谧	米 密 迷 秘 蜜 眉 弥 咪 谜 幂 裔 泌 靡 觅 眯
宦	欢 款 团 换 环 惯 幻 患 缓 唤 喘 娟 蒜 诠 憨
泓	总 红 荣 勇 宏 洪 虹 冻 铜 肿 鸿 轰 哄 绒 弘
醺	许 婚 训 询 寻 讯 迅 循 巡 逊 旬 勋 熏 绚 驯
塾	书 术 熟 束 树 舒 殊 暑 鼠 疏 蔬 抒 赎 薯 墅
亘	选 宣 旋 悬 暅 炫 玄 轩 萱 喧 渲 绚 璇 嬛 眩
遴	引 李 林 临 邻 厘 劣 琳 淋 赁 敛 锌 沥 麟 霖
躇	出 吃 处 初 除 楚 础 触 储 筹 池 厨 酬 丶 橱
炯	经 将 京 惊 竞 雄 穷 熊 疆 姜 酱 囧 浆 璟 鲸
涪	服 付 父 富 府 附 妇 符 幅 肤 傅 抚 弗 辐 俯
煸	变 先 见 边 编 遍 搬 辩 滨 莲 辨 贬 鞭 帘 黏
汴	变 先 见 边 编 遍 搬 辩 滨 莲 辨 贬 鞭 帘 黏
拈	年 片 边 念 偏 填 莲 殿 遣 铅 掂 碱 敛 黏 碾
砾	理 里 力 利 历 励 厉 厘 璃 哩 荔 吏 篱 鲤 俐
厝	错 罗 坐 促 措 惑 粗 催 妥 脆 裸 挫 裹 翠 陀
漯	座 落 罗 伦 诺 洛 逻 裸 啰 萝 螺 囖 骆 锣 磋
拮	接 结 节 界 姐 介 街 借 截 揭 捷 戒 皆 劫 羯
坻	地 第 低 底 弟 递 帝 滴 迪 抵 敌 堤 笛 旳 缔
砥	之 知 只 直 质 值 智 纸 址 枝 脂 汁 吱 秩 稚
榷	越 确 却 切 曲 趣 缺 趋 屈 诀 崛 茄 靴 妾 怯
汞	工 公 东 从 功 共 供 攻 恐 宫 贡 恭 泳 踪 鸿
赈	真 镇 针 珍 圳 震 阵 诊 振 侦 贞 甄 帧 疹 臻
璞	普 铺 吐 辅 污 谱 驱 扑 浦 葡 菩 埔 仆 蒲 噗
垩	哦 额 恶 俄 呃 噩 厄 鄂 遏 娥 讹 扼 胺 峨 鳄
踌	出 后 手 处 州 触 抽 厚 丑 筹 厨 臭 酬 愁 宙
赊	设 社 适 摄 舍 射 涉 彻 氏 吓 厦 蛇 奢 舌 嘘
铉	选 宣 旋 悬 暅 炫 玄 轩 萱 喧 渲 绚 璇 嬛 眩
荚	家 加 价 假 酒 佳 架 驾 甲 嘉 嫁 夹 贾 煎 迦
皙	西 喜 习 吸 媳 晰 稀 溪 夕 兮 茜 玺 犀 烯 熄
虱	什 实 师 试 世 视 式 使 失 识 示 士 适 饰 狮
暄	选 宣 旋 悬 暅 炫 玄 轩 萱 喧 渲 绚 璇 嬛 眩
莪	哦 额 恶 俄 呃 噩 厄 鄂 遏 娥 讹 扼 胺 峨 鳄
苒	然 板 饭 盘 染 燃 壬 攀 刃 贩 炭 滥 衍 扳 焊
瑛	应 影 英 营 硬 映 赢 颖 鹰 樱 莹 荧 蝇 萤 莺
乜	结 姐 届 杰 烈 截 捷 灭 邪 妮 憋 捏 孽 聂 邂
篓	又 路 头 楼 否 录 露 豆 陆 搜 透 漏 炉 喽 苟
蜚	费 非 飞 肥 菲 废 啡 胃 肺 妃 匪 沸 绯 猥 镁
囡	男 难 南 演 满 版 晚 弹 湾 沿 函 杆 堪 楠 腕
蝈	国 过 果 规 故 锅 郭 洛 稿 裹 撮 咕 磋 椁 帼
蛰	这 着 者 致 折 喆 哲 浙 遮 柱 煮 吱 辙 褶 辄
猕	极 米 密 迷 秘 蜜 眉 弥 咪 谜 幂 泌 靡 觅 眯
蠕	如 入 母 故 诉 吴 虎 予 乳 狱 腹 雾 辱 儒 嘟
胯	话 化 快 困 咯 跨 滑 亏 扩 瓜 夸 阔 哗 葵 垮
溧	理 里 力 利 历 励 厉 厘 璃 哩 荔 吏 篱 鲤 俐
毂	股 故 古 顾 估 鼓 固 孤 姑 谷 雇 辜 菇 咕 沽
攥	源 换 环 断 愿 软 钻 苑 卵 冤 桓 棺 萱 瞻 眷
挝	我 无 播 握 佛 卧 窝 哟 乌 沃 涡 伍 喔 倭 蜗
偃	验 延 炎 燕 盐 沿 岩 掩 宴 咽 衍 彦 腌 堰 晏
匕	比 毕 笔 币 避 闭 鼻 彼 壁 碧 鄙 弊 臂 屄 庇
颌	个 格 歌 各 色 哥 革 隔 割 戈 葛 鸽 阁 搁 啧
褂	关 华 股 归 怪 挂 锅 谷 滚 瓜 夸 瑰 龟 拐 硅
泠	零 领 另 灵 令 龄 晶 凌 玲 铃 陵 岭 菱 聆 伶
溥	破 婆 默 魔 霸 坡 陌 脉 颇 泼 蜗 趴 菩 珀 陂
咿	意 已 义 医 移 仪 伊 谊 疫 毅 椅 溢 怡 祎 颐
昱	于 愉 郁 愚 寓 喻 浴 裕 於 舆 渝 淤 吁 钰 禺
蚤	包 早 造 左 貌 毫 遭 槽 抛 栽 绕 熬 糟 躁 澡
腚	定 清 顶 订 档 硬 竞 丁 径 冻 鼎 钉 盯 叮 靖
涎	现 先 限 险 显 县 鲜 闲 仙 陷 嫌 贤 羡 咁 纤
娲	妈 它 达 马 吴 娃 挖 哇 瓦 鸭 叭 雾 爬 喔 袜
骡	落 罗 弱 伦 洛 逻 哆 裸 啰 萝 螺 囖 搓 仑 骆
蚝	好 号 导 络 毛 豪 毫 薄 耗 浩 胞 昭 嚎 昊 壕
蹿	原 院 选 软 寸 串 旋 贯 纶 渲 猿 垣 惭 窜 篡
沭	书 术 熟 束 树 舒 殊 暑 鼠 疏 蔬 抒 赎 薯 墅
瘠	己 机 集 击 激 辑 既 寂 忌 稽 饥 姬 嫉 脊 妓
衩	差 楚 察 沙 触 茶 插 扎 莎 叉 耻 侈 蝉 岔 榨
谏	件 建 简 检 坚 监 剑 兼 鉴 艰 舰 奸 箭 煎 捡
怆	装 创 川 床 妆 窗 畅 肠 霜 闯 煌 晃 恍 疮 幢
玷	点 电 店 段 连 典 垫 歉 莲 羡 颠 淀 殿 扂 巅
鸢	原 院 元 远 源 愿 园 缘 圆 怨 援 袁 苑 冤 渊
恙	样 养 阳 杨 央 洋 扬 羊 仰 氧 旸 痒 磅 烊 秧
蓟	己 机 集 击 激 辑 既 寂 忌 稽 饥 姬 嫉 脊 妓
寮	消 销 料 聊 疗 漂 炼 吊 孝 辽 肖 郊 撩 饺 寥
箔	包 博 播 波 伯 拨 脉 剥 玻 勃 搏 泊 驳 脖 屄
翊	意 已 义 医 移 仪 伊 谊 疫 毅 椅 溢 怡 祎 颐
捋	落 罗 弱 伦 洛 逻 哆 裸 啰 萝 螺 囖 仑 骆 锣
蕙	惠 汇 挥 慧 灰 悔 辉 徽 毁 绘 恢 贿 讳 卉 晖
骛	五 无 物 午 武 舞 吴 悟 乌 伍 呜 勿 吾 巫 唔
覃	谈 范 弹 探 坛 坦 摊 贪 叹 碳 滩 炭 吞 谭 潭
膺	应 影 英 营 迎 硬 映 赢 盈 颖 鹰 樱 荧 蝇 萤
啷	浪 朗 汤 荡 烂 懒 狼 郎 廊 澜 菱 磅 嗓 琅 梆
傀	快 鬼 嘴 哭 亏 轨 馈 愧 溃 葵 窥 盔 魁 奎 匮
淬	随 鬼 嘴 醉 磁 催 脆 挫 驰 齿 粹 翠 崔 锤 咀
痿	未 维 卫 谓 危 违 尾 胃 薇 韦 畏 潍 纬 猥 萎
剽	条 票 效 料 挑 缴 漂 焦 妙 朴 飘 瞧 郊 嫖 貂
馄	户 运 华 准 婚 伦 混 幻 呼 魂 遵 浑 昏 仑 焕
哧	吃 持 至 迟 池 尺 赤 痴 驰 齿 耻 斥 侈 翅 炽
轲	可 科 客 课 克 刻 哭 颗 渴 壳 柯 磕 棵 噩 苛
辘	路 录 陆 绿 鲁 鹿 炉 卢 碌 撸 芦 璐 卤 庐 禄
啄	主 著 桌 卓 祸 捉 丶 烛 爪 拙 灼 赘 浊 绰 酌
楔	些 解 谢 写 协 鞋 械 邪 谐 蟹 携 泄 蝎 歇 卸
姣	教 交 校 较 叫 角 脚 缴 焦 胶 娇 骄 郊 矫 搅
恿	用 应 永 拥 勇 孔 虹 庸 泳 涌 讼 佣 咏 弓 雍
蛟	教 交 校 较 叫 角 脚 缴 焦 胶 娇 骄 郊 矫 搅
垭	亚 呀 压 夜 雅 牙 罚 押 涯 鸭 丫 吖 芽 讶 哑
瞰	看 板 按 盘 谈 范 慢 寒 刊 堪 砍 坎 侃 勘 炭
吒	查 插 猪 咋 召 扎 炸 渣 诈 詹 挚 闸 榨 眨 乍
卅	把 哪 它 马 阿 斯 素 咯 玛 踏 撒 萨 扒 洒 葩
儡	类 微 累 陪 雷 泪 勒 蕾 磊 贼 妃 诶 嗨 蔚 昧
眺	校 调 条 跳 挑 苗 椒 轿 侨 寥 恬 嫖 婊 廖 窖
噌	程 风 层 嗡 冷 疼 乘 蒙 横 撑 赠 冯 扔 蹭 藤
铿	等 更 控 曾 层 康 仍 恐 坑 泵 梗 啃 澎 烹 憎
蹴	组 足 族 租 虚 陆 巨 库 偶 聚 祖 阻 卒 诅 戮
臧	航 钢 咱 扬 仓 亡 芳 脏 氧 葬 冈 舱 扛 壤 肪
膘	表 变 校 标 暴 脚 飘 浇 飙 彪 婊 刁 僚 镖 枭
藐	教 交 跳 描 妙 鸟 秒 苗 骄 喵 悄 庙 饺 渺 嫖
驮	多 读 货 队 夺 朵 哆 躲 萝 堕 裹 稻 捣 剁 惰
袅	校 聊 焦 妙 鸟 恼 尿 萧 宵 钓 饺 逍 叼 瞄 缭
谕	于 愉 郁 愚 寓 喻 浴 裕 於 舆 渝 淤 吁 钰 禺
淅	西 喜 习 吸 媳 晰 稀 溪 夕 兮 茜 犀 烯 熄 嬉
癞	来 代 再 劳 嘅 耐 赖 莱 唻 歪 粒 滥 沥 垒 睐
雹	保 报 包 宝 抱 爆 暴 薄 耀 饱 堡 剥 胞 曝 豹
饨	团 村 谈 困 迅 徒 俊 叹 循 菌 吞 陀 毯 屯 臀
娆	导 告 澳 盗 邀 逃 遭 稿 扰 腰 矛 绕 饶 郝 苞
杵	出 处 初 除 熟 楚 础 触 叔 扯 储 厨 柱 戳 橱
瓮	梦 增 曾 嗡 登 闻 哼 庚 蚊 枫 翁 懵 膨 僧 绷
亳	包 博 播 波 魔 伯 拨 脉 玻 勃 搏 泊 驳 脖 屄
氰	情 请 清 精 英 亲 青 轻 庆 倾 睛 晴 坪 卿 菱
铢	主 住 助 祝 筑 猪 逐 珠 诸 竹 驻 柱 丶 烛 株
嚓	此 亚 怕 彩 爸 厕 罚 擦 涯 哒 疤 坝 灿 喇 蛤
圩	未 维 味 围 谓 唯 慰 伪 喂 薇 魏 韦 畏 纬 炜
莅	理 里 力 利 历 励 厉 厘 璃 哩 荔 吏 篱 鲤 俐
蓦	模 默 魔 末 摩 莫 磨 摸 膜 墨 陌 脉 寞 抹 漠
壑	和 合 呢 设 何 则 呵 河 核 喝 虎 盒 荷 吓 赫
勐	明 梦 增 盟 蒙 萌 恒 赠 猛 铭 孟 冥 庚 懵 愣
岖	去 区 取 句 独 曲 趣 趋 驱 屈 渠 叙 娶 躯 佢
榔	放 龙 浪 洋 钢 朗 凌 隆 粮 狼 芳 郎 痒 沧 廊
荏	人 本 然 文 问 认 任 忍 仁 闷 笨 扔 韧 壬 刃
珈	家 加 价 假 酒 佳 架 驾 甲 嘉 嫁 夹 贾 煎 迦
榈	女 路 立 律 率 旅 虑 厉 垃 侣 履 卢 撸 吕 滤
滦	乱 幻 缘 圆 卷 冠 链 缓 炼 览 烂 怨 泉 懒 篮
锲	且 切 协 勤 揭 械 叠 窃 斜 捏 伽 茄 妾 怯 惬
唰	化 属 啥 杀 输 刷 树 傻 瞬 耍 疏 摔 甩 墅 朔
焯	主 著 桌 卓 祸 捉 丶 烛 爪 拙 灼 赘 浊 绰 酌
搐	出 后 手 处 州 售 洲 抽 厚 授 丑 筹 厨 臭 酬
鼬	友 又 游 由 优 油 右 邮 幼 忧 幽 悠 犹 诱 呦
犷	管 光 广 刚 况 馆 惯 狂 钢 逛 贯 纲 凰 谎 灌
瀛	应 影 英 营 迎 硬 映 赢 盈 颖 莹 荧 蝇 萤 莺
皎	教 交 校 较 叫 角 脚 缴 焦 胶 娇 骄 郊 矫 搅
隍	黄 皇 荒 框 凰 谎 慌 煌 晃 恍 焕 惶 簧 潢 徨
俾	比 毕 笔 币 避 闭 鼻 彼 壁 碧 鄙 弊 臂 屄 庇
骐	其 期 七 气 妻 戚 棋 琦 凄 祁 麒 迄 杞 祺 亟
椁	国 过 果 规 故 锅 郭 洛 裹 剁 撮 咕 呱 铎 磋
嗔	称 陈 甚 沉 晨 撤 阵 沈 撑 尘 辰 臣 趁 衬 枕
鞅	样 养 阳 防 杨 央 洋 扬 羊 仰 氧 旸 纺 痒 烊
婺	五 物 午 武 舞 吴 悟 乌 伍 呜 勿 吾 巫 唔 坞
盂	于 预 遇 域 雨 宇 愉 郁 愚 寓 逾 瑜 舆 榆 俞
诿	未 维 味 围 谓 唯 慰 伪 喂 薇 魏 韦 畏 纬 炜
萏	但 单 待 验 担 蛋 淡 丹 旦 胆 诞 耽 叨 拌 蚕
铐	考 早 造 靠 淘 烤 骚 阔 躁 澡 砍 坎 岆 瑶 拷
湮	验 严 延 炎 燕 盐 沿 岩 掩 宴 咽 衍 彦 妍 腌
沱	讨 索 托 脱 锁 拖 拓 桃 陶 妥 魄 陀 驼 唾 糯
皈	规 贵 归 鬼 孤 柜 滚 瓜 碎 轨 跪 瑰 桂 闺 粹
瑄	选 宣 旋 悬 暅 炫 玄 轩 萱 喧 渲 绚 璇 嬛 眩
蹉	活 错 获 措 惑 夺 哆 挫 裹 翠 豁 醋 嗦 搓 璀
筏	发 法 把 哪 妈 它 拉 阿 负 富 罚 乏 扒 鸭 叭
祉	之 知 只 直 质 值 智 枝 脂 汁 吱 秩 稚 蜘 炙
扈	户 护 互 乎 湖 呼 胡 虎 忽 糊 沪 壶 蝴 葫 弧
糠	房 康 访 央 棒 钢 抗 矿 仰 旸 勘 痒 沧 扛 壤
啾	就 九 究 酒 久 救 旧 纠 仇 舅 揪 玖 韭 灸 钮
纂	源 换 环 断 愿 软 钻 苑 卵 冤 桓 棺 萱 瞻 眷
遨	早 案 造 奥 澳 傲 熬 凹 瑶 豹 敖 嗷 袄 艹 蘑
丕	被 皮 屁 脾 疲 匹 披 啤 劈 僻 譬 癖 痞 霹 琵
馏	六 流 离 究 留 刘 黎 柳 浏 溜 瘤 榴 硫 朽 谬
摞	落 罗 伦 诺 洛 逻 哆 裸 啰 萝 螺 囖 仑 骆 锣
骥	己 机 集 击 激 辑 既 寂 忌 稽 饥 姬 嫉 脊 妓
瘀	于 愉 郁 愚 寓 喻 浴 裕 於 舆 渝 淤 吁 钰 禺
憩	其 期 七 气 妻 戚 棋 琦 凄 祁 麒 迄 杞 祺 亟
湉	天 团 千 简 田 填 甜 添 舔 帘 掂 碱 敛 癫 黏
咣	管 光 广 刚 况 馆 惯 狂 钢 逛 贯 纲 凰 谎 灌
沅	原 院 元 远 源 愿 缘 圆 怨 援 袁 苑 冤 渊 媛
疱	套 跑 岛 泡 糕 扫 炮 抛 曹 曝 葩 攀 拌 唠 袍
瘁	菜 鬼 嘴 醉 催 脆 挫 驰 齿 粹 翠 崔 锤 搓 摧
鹄	户 护 互 乎 湖 呼 胡 虎 忽 糊 狐 沪 壶 蝴 葫
獗	觉 决 绝 居 借 君 掘 爵 诀 崛 抉 倔 炬 厥 桀
犒	考 早 造 靠 淘 烤 骚 阔 躁 澡 砍 坎 岆 瑶 拷
谑	学 解 续 血 询 雪 阅 鞋 讯 蓄 巡 泄 叙 岳 歇
桢	真 镇 针 珍 圳 阵 诊 振 侦 贞 甄 帧 疹 臻 朕
棣	体 题 提 毕 替 梯 踢 剔 屄 蚁 惕 蹄 涕 剃 嚏
邛	情 青 轻 庆 兄 抢 穷 倾 枪 墙 晴 腔 琼 呛 匈
饽	包 博 播 波 魔 伯 拨 脉 玻 勃 搏 泊 驳 脖 屄
奄	验 严 延 炎 燕 盐 沿 岩 掩 宴 咽 衍 彦 妍 腌
鞘	巧 桥 乔 敲 悄 瞧 雀 侨 翘 俏 掐 窍 缪 撬 枭
糅	友 候 入 楼 油 购 欧 肉 悠 柔 凑 猴 兜 酉 喉
坍	谈 慢 弹 探 坛 坦 摊 贪 叹 碳 滩 炭 烫 谭 潭
漕	包 宝 导 告 跑 劳 操 草 扰 耗 腰 矛 曹 茂 叨
桀	接 结 节 界 姐 介 街 借 截 揭 捷 戒 劫 羯 桔
叱	吃 持 至 迟 池 尺 赤 痴 驰 齿 耻 斥 侈 翅 炽
荞	表 巧 桥 乔 敲 悄 瞧 雀 侨 翘 俏 掐 窍 缪 撬
钜	车 具 据 剧 局 句 居 巨 聚 距 拒 拘 矩 菊 橘
渚	主 住 助 祝 筑 猪 逐 珠 诸 竹 驻 柱 丶 烛 株
烃	听 清 景 挺 停 庭 厅 订 兵 迎 堂 颖 婷 亭 廷
拄	主 住 助 祝 筑 猪 逐 珠 诸 竹 驻 柱 丶 烛 株
婢	毕 笔 币 避 闭 鼻 彼 壁 碧 鄙 弊 臂 屄 毙 庇
飓	车 具 据 剧 局 句 居 巨 聚 距 拒 拘 矩 菊 橘
浔	婚 训 询 寻 讯 迅 循 遵 巡 逊 旬 勋 熏 渲 钝
冽	节 写 列 铁 街 烈 裂 猎 劣 咧 膊 喱 亵 砺 凛
跶	大 打 单 度 达 答 呀 搭 罚 娜 涯 哒 稻 嗒 睹
饕	套 讨 淘 逃 浩 妖 炮 桃 陶 涛 萄 掏 谭 昊 噪
扪	们 门 闻 蒙 敏 纷 闷 眉 玫 氛 狠 嫩 昧 韧 蔓
纭	员 运 云 阅 孕 允 晕 韵 蕴 匀 芸 酝 耘 陨 昀
鄞	因 音 银 引 印 阴 隐 饮 姻 淫 瘾 吟 殷 尹 茵
蜷	全 欢 观 权 券 缓 欠 怨 泉 劝 拳 炫 玄 犬 诠
酰	现 先 限 险 显 县 陷 嫌 贤 羡 咁 纤 弦 宪 咸
袂	没 美 内 买 每 妹 媒 梅 煤 魅 眉 玫 霉 枚 咪
徵	之 知 直 制 质 值 职 置 智 纸 枝 殖 吱 秩 稚
賸	生 证 神 声 省 争 升 征 尚 胜 圣 症 剩 呈 昇
涣	欢 管 源 换 环 惯 幻 患 缓 唤 喘 娟 蒜 诠 焕
摈	音 近 边 遍 避 欣 宾 碧 滨 饼 辨 谨 斌 彬 尹
涿	或 坐 著 珠 赵 桌 卓 驻 捉 拙 椎 灼 浊 酌 镯
鬓	音 近 边 遍 避 欣 宾 碧 滨 饼 辨 谨 斌 彬 尹
崂	老 号 络 劳 草 邀 逃 洛 蹈 牢 捞 姥 佬 昊 噪
蚓	因 音 银 引 印 阴 隐 饮 姻 淫 瘾 吟 殷 尹 茵
讴	族 木 苏 湖 欧 偶 喽 酉 逾 瑜 喉 芦 钩 殴 呕
獭	他 她 图 妈 它 达 塔 踏 瓦 鸭 叭 爬 塌 祂 惕
镳	表 变 校 标 暴 脚 秒 飘 浇 飙 彪 婊 刁 僚 叼
奂	欢 管 源 换 环 惯 幻 患 缓 唤 喘 娟 蒜 诠 焕
蜇	这 着 者 折 喆 哲 浙 遮 柱 汁 煮 殖 辙 褶 辄
碚	费 每 未 配 培 陪 伟 危 赔 佩 脾 薇 纬 沛 劈
螳	堂 洋 唐 糖 汤 躺 塘 趟 旸 纺 烫 壤 毯 棠 倘
魇	验 严 烟 颜 炎 艳 燕 盐 岩 掩 宴 咽 衍 腌 堰
仞	人 分 然 文 问 认 任 忍 仁 闷 笨 愤 韧 壬 刃
兖	验 严 烟 颜 炎 艳 燕 盐 岩 掩 宴 咽 衍 腌 堰
玑	己 机 集 击 激 辑 既 寂 忌 稽 饥 姬 嫉 脊 妓
腴	于 预 遇 域 余 雨 宇 愉 郁 愚 寓 豫 裕 逾 瑜
枰	平 影 形 评 硬 竞 聘 凭 瓶 苹 倾 赢 刑 玲 婴
蔺	李 林 丽 临 邻 劣 璃 琳 淋 赁 锌 麟 霖 吝 磷
帚	注 周 州 洲 守 筑 猪 逐 珠 臭 猴 宙 舟 骤 轴
彗	回 惠 汇 慧 悔 辉 徽 毁 恢 贿 讳 卉 晖 晦 荟
帼	国 过 果 规 故 锅 郭 洛 措 裹 剁 撮 咕 呱 磋
鳝	山 善 删 闪 扇 陕 擅 衫 珊 杉 掺 汕 殇 姗 煽
蚯	求 球 救 秋 琴 仇 丘 窃 钮 邱 琦 凄 囚 糗 遛
堑	钱 千 签 潜 迁 欠 牵 歉 谦 遣 铅 乾 倩 嵌 谴
蕃	反 言 份 饭 范 翻 烦 犯 凡 繁 返 泛 番 沿 帆
肏	包 宝 导 告 跑 劳 操 草 扰 耗 腰 矛 曹 冇 茂
唁	验 严 烟 颜 炎 艳 燕 盐 岩 掩 宴 咽 衍 腌 堰
踞	车 具 据 剧 局 句 居 巨 聚 距 拒 惧 拘 矩 菊
颉	接 结 节 界 姐 介 街 借 洁 截 揭 劫 羯 竭 桔
茱	主 住 助 祝 筑 猪 逐 珠 诸 竹 驻 柱 丶 烛 株
杳	要 约 药 摇 邀 腰 妖 桃 耀 遥 咬 谣 岆 瑶 姚
恣	自 子 资 字 咨 仔 紫 姿 滋 兹 淄 梓 疵 呲 渍
鸾	原 选 软 练 恋 乱 援 栏 旋 贯 劝 卵 婪 窜 阮
琰	验 严 烟 颜 炎 艳 燕 盐 岩 掩 宴 咽 衍 腌 堰
儋	但 单 待 验 板 担 蛋 淡 丹 旦 胆 诞 耽 叨 拌
蛹	用 永 拥 硬 勇 仰 庸 泳 鸿 涌 筒 佣 痒 咏 雍
偌	若 弱 锁 朵 乳 逻 拓 萝 琢 魄 梭 挪 饶 唾 锣
臊	号 包 赛 刀 散 淘 盗 邀 扫 曝 骚 嫂 冇 嚎 袍
铣	西 喜 习 吸 媳 晰 稀 溪 夕 兮 茜 犀 烯 熄 嬉
孑	接 结 节 界 姐 介 街 借 洁 截 揭 劫 羯 竭 桔
荨	训 询 寻 讯 迅 循 巡 逊 旬 勋 沦 熏 钝 驯 薰
耦	族 木 苏 湖 欧 偶 喽 酉 逾 瑜 喉 芦 钩 殴 呕
臃	用 永 拥 勇 隆 虹 庸 婴 泳 涌 笼 佣 溶 咏 雍
祢	你 尼 忆 拟 紫 泥 逆 妮 埃 欸 腻 伱 倪 霓 匿
谆	展 传 注 准 魂 桌 朱 诸 赘 臻 浊 荤 酌 镯 锥
颦	品 片 音 尽 频 临 拼 贫 淋 潘 匹 鑫 叛 钦 沁
眈	但 单 待 验 担 蛋 淡 丹 旦 胆 诞 耽 叨 拌 氮
缄	间 见 检 坚 荐 键 剑 兼 践 鉴 浅 剪 艰 奸 煎
蜥	西 喜 习 吸 媳 晰 稀 溪 夕 兮 茜 玺 犀 烯 嬉
讧	总 红 荣 勇 宏 洪 虹 冻 肿 鸿 轰 哄 绒 弘 烘
缮	山 伤 善 沙 删 闪 扇 陕 擅 衫 珊 杉 掺 汕 殇
硼	更 朋 曾 层 登 灯 聘 碰 萌 崩 捧 鹏 扔 彭 棚
骅	话 化 花 华 画 划 互 坏 湖 虎 滑 缓 昏 淮 哗
徕	来 代 再 劳 嘅 耐 赖 莱 唻 歪 沥 垒 睐 岚 榄
莒	车 具 据 剧 局 居 巨 聚 距 拒 拘 矩 菊 橘 狙
岌	己 机 集 击 激 辑 既 寂 忌 稽 饥 姬 嫉 脊 妓
捺	那 她 哪 拿 拉 阿 脑 呀 纳 娜 腻 塌 呐 阀 喇
庾	于 预 遇 域 余 雨 宇 愉 郁 愚 寓 豫 裕 逾 瑜
坳	博 早 案 造 奥 澳 傲 熬 凹 瑶 敖 嗷 袄 艹 懊
瘙	号 包 刀 散 淘 盗 邀 扫 曝 骚 嫂 冇 嚎 袍 叁
夙	诉 速 素 舞 苏 宿 俗 塑 傅 肃 凸 醋 吾 舆 巫
妲	大 打 达 答 爸 呀 搭 罚 娜 娃 哒 嗒 黛 睹 怠
蜈	五 无 物 午 武 舞 吴 悟 乌 伍 呜 勿 吾 巫 唔
笈	计 级 及 集 即 急 吉 既 剂 寂 挤 脊 羁 畸 藉
蟾	产 春 察 朝 串 憾 缠 擅 阐 禅 馋 珊 蝉 湛 掺
餮	特 谢 节 写 列 贴 铁 帖 替 械 捷 斜 捏 咧 竭
罔	网 让 望 玩 帮 王 往 忘 亡 糖 旁 汤 仿 旺 汪
跎	讨 索 托 脱 锁 拖 拓 桃 陶 妥 萝 魄 陀 驼 唾
悻	行 性 星 亲 京 形 型 兴 幸 醒 姓 刑 睛 馨 菱
嵊	生 整 声 省 升 甚 胜 圣 盛 剩 撑 昇 牲 绳 甸
钬	活 或 货 火 获 伙 拖 魂 扩 惑 霍 祸 豁 昊 剁
姝	书 术 熟 输 束 树 舒 殊 暑 鼠 疏 蔬 抒 赎 竖
撷	些 解 写 协 鞋 械 邪 谐 蟹 携 泄 蝎 歇 卸 胁
瞟	票 跳 偏 漂 焦 胶 乔 抛 朴 飘 饺 嫖 瞄 蝙 凋
劾	和 合 呢 设 何 德 则 呵 河 核 喝 盒 荷 吓 赫
蛎	理 里 力 利 历 励 厉 厘 璃 哩 荔 吏 篱 鲤 俐
脍	开 快 块 怪 跨 夸 乖 馈 慨 淮 楷 恺 徊 筷 魁
栎	月 觉 与 越 血 缺 雪 阅 孕 悦 跃 岳 御 掘 玥
犟	相 两 量 将 京 讲 江 奖 降 娘 枪 晶 井 粮 疆
钣	办 班 版 半 般 板 慢 巴 伴 搬 颁 斑 扮 瓣 鞭
觊	计 级 及 集 即 急 吉 既 剂 寂 挤 脊 羁 畸 藉
潺	产 春 察 朝 串 憾 缠 擅 阐 禅 馋 珊 蝉 湛 掺
鬟	欢 管 源 换 环 惯 幻 患 缓 唤 喘 娟 蒜 诠 焕
嬅	话 化 花 华 画 划 互 坏 湖 虎 滑 缓 昏 淮 哗
佗	索 托 脱 锁 拖 拓 陶 妥 魄 屠 陀 驼 唾 糯 灬
咤	制 找 查 差 志 珠 咋 扎 炸 渣 诈 罩 闸 榨 眨
涸	好 号 宝 导 靠 毛 豪 毫 薄 耗 浩 绕 胞 嚎 昊
觎	于 预 遇 域 余 雨 宇 愉 郁 愚 寓 豫 裕 逾 瑜
踱	多 读 货 队 夺 朵 哆 躲 萝 堕 裹 稻 捣 剁 惰
颍	应 影 英 营 迎 硬 映 赢 盈 颖 鹰 樱 莹 荧 蝇
暹	现 先 限 险 显 县 鲜 仙 陷 嫌 贤 羡 咁 纤 弦
蠡	理 里 力 利 历 励 厉 厘 璃 哩 荔 吏 篱 鲤 俐
霎	哈 设 势 啥 杀 沙 傻 涉 狮 烧 厦 纱 莎 蚀 匙
罄	情 请 清 星 亲 青 轻 庆 倾 勤 枪 睛 晴 卿 菱
琍	理 里 力 利 历 励 厉 厘 璃 哩 荔 吏 篱 鲤 俐
砼	同 通 统 痛 童 铜 筒 桶 讼 躺 桐 彤 瞳 耸 珑
赝	验 严 烟 颜 炎 艳 燕 盐 沿 岩 掩 宴 咽 衍 腌
芡	前 钱 千 签 潜 迁 欠 牵 歉 谦 遣 铅 乾 倩 嵌
婵	产 春 察 朝 串 憾 缠 擅 阐 禅 馋 珊 蝉 湛 掺
茴	回 惠 汇 慧 灰 悔 辉 徽 毁 恢 贿 讳 卉 晖 晦
涞	来 代 再 劳 嘅 耐 赖 莱 唻 歪 粒 沥 垒 睐 岚
斡	我 握 魔 卧 窝 沃 陌 脉 涡 伍 噢 玻 喔 倭 敖
幡	反 言 饭 范 翻 烦 犯 凡 繁 返 泛 番 沿 函 帆
莠	友 又 游 由 优 油 右 邮 幼 忧 幽 悠 犹 诱 呦
蹩	些 别 贴 鼻 揭 械 蟹 憋 辟 蔽 茄 屄 桔 鳎 瘪
毡	展 站 战 占 粘 胀 撼 兆 擅 颤 晗 詹 沾 斩 湛
蝗	黄 状 狂 皇 壮 荒 凰 谎 慌 煌 晃 恍 旷 幢 惶
鸵	索 托 脱 锁 拖 拓 陶 妥 萝 魄 屠 陀 驼 唾 糯
峦	乱 幻 缘 圆 卷 冠 链 缓 炼 览 烂 怨 泉 懒 篮
煦	需 许 续 须 序 虚 绪 徐 蓄 叙 旭 畜 絮 恤 婿
吮	属 顺 审 熟 舒 孙 魂 瞬 慎 疏 梳 绅 讪 荤 赡
铆	报 号 毛 爆 猫 贸 貌 澳 冒 矛 苗 帽 茅 冇 茂
漉	路 录 陆 绿 鲁 鹿 炉 卢 撸 芦 璐 卤 庐 禄 噜
镕	总 容 融 童 拥 松 荣 笼 佣 匆 蓉 绒 溶 垄 壤
鳅	求 球 救 秋 仇 丘 寝 钮 邱 琦 凄 囚 臼 糗 遛
弑	什 实 师 试 世 视 式 使 失 识 示 士 适 饰 狮
焱	验 严 烟 颜 炎 艳 燕 盐 岩 掩 宴 咽 衍 腌 堰
戬	件 见 简 检 坚 健 监 键 浅 剪 肩 舰 奸 煎 捡
妤	于 预 遇 域 余 雨 宇 愉 郁 愚 寓 豫 裕 逾 瑜
琏	联 连 练 恋 脸 链 炼 怜 莲 廉 弦 勉 帘 敛 镰
纨	完 万 玩 晚 湾 厌 弯 碗 挽 塆 丸 婉 顽 腕 宛
窿	空 领 龙 恐 隆 庸 泳 笼 桐 垄 拢 珑 聋 胧 陇
斛	户 护 互 乎 湖 呼 胡 虎 忽 糊 狐 沪 壶 蝴 葫
蛐	去 区 取 曲 趣 幅 趋 驱 屈 渠 叙 愈 娶 躯 佢
郫	批 皮 屁 脾 疲 匹 披 啤 劈 癖 坯 霹 琵 毗 媲
蝌	可 科 客 课 克 刻 哭 颗 渴 壳 葛 柯 磕 棵 苛
蹂	友 候 入 楼 油 购 欧 肉 悠 柔 凑 猴 兜 酉 喉
镂	六 流 楼 否 录 露 豆 陆 扣 逗 漏 炉 喽 苟 陋
徉	样 望 养 阳 杨 央 洋 扬 羊 仰 炎 氧 旸 痒 烊
徜	长 场 常 唱 厂 偿 昌 尝 畅 杭 丈 呈 肠 胀 倡
娑	所 错 坐 苏 索 锁 缩 洛 措 惑 夺 扫 霍 琐 琢
鹜	五 无 物 午 武 舞 吴 悟 乌 伍 呜 勿 吾 巫 唔
蚪	优 读 独 斗 豆 扣 偷 尤 柔 逗 兜 抖 痘 剖 陡
樨	西 喜 习 吸 媳 晰 稀 溪 夕 兮 茜 玺 犀 烯 嬉
孺	如 入 故 诉 付 孤 吴 宇 虎 予 乳 狱 腹 雾 辱
罂	应 影 英 硬 映 赢 盈 颖 婴 鹰 樱 莹 荧 蝇 萤
躏	引 李 林 临 邻 厘 劣 琳 淋 赁 敛 锌 沥 麟 霖
桎	之 知 只 质 值 智 纸 址 枝 脂 汁 吱 秩 稚 挚
傣	代 海 孩 带 待 材 嘚 贷 莱 戴 呆 袋 歪 歹 黛
罹	理 里 力 利 历 励 厉 厘 璃 哩 荔 吏 篱 鲤 俐
咝	四 司 思 死 斯 食 依 激 似 丝 私 撕 寺 肆 饲
蟠	干 研 便 满 盘 判 探 湾 蓝 胖 俺 盼 潘 叛 攀
袤	目 头 构 某 幼 奏 忧 谋 侯 吼 沫 麽 牟 眸 垢
赅	外 买 百 该 改 待 卖 概 敢 盖 柏 袋 闺 尴 钙
瘴	长 重 正 场 张 章 掌 账 涨 障 症 畅 帐 丈 胀
抡	论 均 讯 轮 伦 寸 晕 循 鹿 裸 沦 熏 麟 缆 璐
珏	觉 决 绝 居 借 拒 掘 薛 爵 诀 崛 抉 倔 炬 厥
盹	困 蛋 损 顿 盾 敦 逊 裙 吨 蹲 芸 镀 囤 舵 笋
噼	批 皮 屁 脾 疲 匹 披 啤 劈 癖 坯 霹 琵 毗 媲
梏	觉 决 绝 居 借 拒 掘 薛 爵 诀 崛 抉 倔 炬 厥
俚	理 里 力 利 历 励 厉 厘 璃 哩 荔 吏 篱 鲤 俐
裨	比 毕 笔 币 避 闭 鼻 彼 壁 碧 鄙 弊 臂 屄 庇
狒	费 非 飞 肥 菲 废 啡 胃 肺 妃 匪 沸 绯 嘞 翡
蛳	四 司 思 死 斯 食 击 似 丝 私 姨 撕 寺 肆 饲
奘	转 装 状 赚 床 庄 妆 窗 爽 撞 壮 荒 胀 霜 闯
囔	放 男 房 杨 访 央 棒 钢 仰 囊 旸 痒 沧 壤 棠
邬	五 无 物 午 武 舞 吴 悟 乌 伍 呜 勿 吾 巫 唔
踮	点 电 店 连 典 垫 肩 歉 莲 吊 舰 颠 淀 殿 扂
铀	友 又 游 由 优 油 右 邮 幼 忧 幽 悠 犹 诱 呦
痂	家 加 价 假 酒 佳 架 驾 甲 嘉 嫁 夹 贾 迦 钾
旮	哪 该 格 它 干 达 巴 孤 扒 葛 塌 尬 疤 膏 噶
狞	清 星 精 宁 苹 倾 赢 刑 凝 卿 菱 擎 璟 腥 柠
帛	包 博 播 波 魔 伯 拨 玻 勃 搏 泊 驳 脖 蜗 渤
谗	产 春 察 朝 串 憾 缠 擅 阐 禅 馋 珊 蝉 湛 掺
隼	军 询 索 损 孙 碎 俊 晕 沦 蹲 仑 笋 酥 炖 郡
泫	选 宣 旋 悬 暅 炫 玄 轩 萱 喧 渲 绚 璇 嬛 眩
镭	类 累 陪 雷 泪 勒 蕾 磊 贼 妃 诶 蔚 昧 垒 嘞
簪	验 饭 严 赞 湾 咱 暂 胖 叛 咽 撼 氨 挽 攒 楠
娣	地 第 低 底 弟 递 帝 滴 迪 抵 敌 蒂 堤 笛 旳
蹶	觉 决 绝 居 借 拒 掘 薛 爵 诀 崛 抉 倔 炬 厥
惴	制 追 灰 悔 吹 辉 桌 坠 株 嘱 铸 诛 拙 蛛 拽
忿	分 份 飞 粉 奋 菲 疯 废 纷 番 氛 愤 芬 妃 嫩
箩	座 落 罗 伦 诺 洛 逻 裸 啰 萝 碌 螺 囖 仑 骆
粼	引 李 林 临 邻 厘 劣 琳 淋 赁 敛 锌 沥 麟 霖
鄱	破 婆 默 魔 霸 坡 陌 脉 颇 泼 蜗 趴 菩 珀 陂
碁	其 期 七 气 妻 戚 棋 琦 凄 祁 麒 迄 杞 祺 亟
槌	回 吃 触 吹 恢 尺 催 厨 垂 唇 侈 锤 橱 晖 赘
衲	那 哪 拿 码 亚 怕 纳 罚 娜 涯 哒 呐 啪 匿 噶
骞	前 钱 千 潜 迁 欠 牵 歉 谦 遣 铅 乾 倩 嵌 黔
恻	格 哦 责 策 词 测 册 侧 厕 叶 刺 粗 擦 磁 割
濂	现 线 险 显 县 献 闲 陷 嫌 贤 纤 弦 宪 咸 掀
嵘	容 融 童 拥 松 荣 笼 佣 匆 蓉 绒 溶 桐 垄 壤
挛	乱 幻 缘 圆 卷 冠 链 缓 炼 览 烂 怨 泉 懒 篮
渥	我 播 握 佛 魔 末 卧 窝 沃 陌 脉 涡 伍 喔 勿
泞	清 星 精 宁 苹 倾 赢 刑 凝 坪 卿 菱 擎 璟 柠
侗	同 通 总 统 痛 童 铜 筒 桶 婷 佣 匆 丛 桐 彤
嬴	应 影 英 硬 映 赢 盈 颖 鹰 樱 莹 荧 蝇 萤 莺
篝	友 候 够 购 构 狗 偷 沟 奏 勾 吼 雇 钩 菇 苟
抻	称 陈 诚 沉 珍 晨 沈 撑 尘 狠 振 辰 臣 痕 趁
蹒	干 研 便 满 版 盘 判 探 蓝 胖 俺 盼 潘 叛 攀
纣	周 州 洲 猪 逐 奏 愁 猴 煮 宙 舟 骤 轴 咒 粥
锏	件 见 简 检 坚 健 监 键 浅 剪 肩 舰 奸 煎 捡
攫	觉 决 绝 居 借 拒 掘 薛 爵 诀 崛 抉 倔 炬 厥
鳗	满 板 谈 范 慢 漫 蛮 曼 番 埋 迈 婉 谭 衍 瞒
痨	老 号 络 劳 疗 邀 逃 洛 熬 牢 捞 姥 佬 幺 喇
溴	修 秀 休 旧 羞 媳 仇 锡 袖 绣 昔 膝 钮 锈 朽
掣	河 陈 扯 彻 撤 吓 尘 尺 厨 澈 矗 嗤 蔗 褚 忱
鍜	下 西 喜 消 夏 俩 侠 瞎 霞 萧 虾 辖 峡 狭 暇
骊	理 里 力 利 历 励 厉 厘 璃 哩 荔 吏 篱 鲤 俐
芪	其 七 气 妻 戚 棋 琦 凄 祁 麒 迄 杞 祺 亟 岐
蜴	意 已 义 医 移 仪 伊 谊 疫 毅 椅 溢 怡 祎 颐
蜒	验 严 烟 颜 炎 艳 燕 盐 沿 岩 掩 宴 衍 腌 堰
戍	书 术 属 述 树 舒 叔 殊 暑 署 疏 蔬 梳 抒 赎
淖	告 脑 闹 邀 逃 遭 稿 扰 耗 腰 矛 恼 苞 钠 挠
剐	果 关 华 股 归 怪 挂 锅 谷 滚 瓜 瑰 龟 拐 硅
藓	现 线 险 显 县 献 闲 陷 嫌 贤 羡 纤 弦 宪 咸
跚	山 善 删 闪 扇 陕 擅 衫 珊 杉 掺 汕 姗 煽 讪
骜	早 案 造 奥 澳 傲 熬 凹 瑶 敖 嗷 袄 艹 蘑 懊
睑	间 件 建 检 健 监 荐 键 践 浅 剪 舰 奸 箭 煎
晔	也 业 夜 爷 野 页 叶 宇 隔 液 耶 椰 冶 噎 烨
痉	经 京 景 警 静 惊 竞 镜 净 径 晶 井 颈 荆 靖
锭	定 名 东 清 青 顶 订 镜 净 丁 鼎 颈 钉 盯 冥
瞠	重 正 证 政 整 省 争 涨 征 震 郑 症 忠 挣 蒸
鲵	你 立 尼 拟 敌 泥 逆 妮 碍 埃 腻 伱 倪 霓 匿
叟	由 楼 优 首 投 搜 兜 署 肃 抖 疏 嗽 艘 鱿 黍
柾	就 九 究 酒 久 救 旧 纠 舅 揪 玖 韭 灸 钮 疚
痧	哈 式 势 啥 杀 沙 傻 涉 狮 烧 咋 厦 纱 莎 匙
缰	相 两 量 将 京 讲 江 奖 降 娘 枪 晶 井 粮 疆
蚣	工 公 东 功 共 供 攻 恐 宫 贡 恭 泳 踪 颂 绒
貔	批 皮 屁 脾 疲 匹 披 啤 劈 癖 坯 霹 琵 毗 媲
矾	反 言 份 饭 范 翻 烦 犯 凡 繁 返 泛 番 沿 帆
垠	因 音 言 银 引 印 阴 隐 饮 姻 淫 瘾 吟 殷 尹
潞	录 绿 鲁 炉 卢 碌 撸 芦 璐 卤 庐 禄 噜 泸 虏
柩	就 九 究 酒 久 救 旧 阶 纠 舅 揪 玖 韭 灸 暨
刽	规 贵 归 鬼 孤 柜 瓜 碎 轨 跪 瑰 桂 闺 粹 龟
砝	发 法 亚 怕 饭 附 罚 乏 伏 覆 伐 砸 祂 阀 哑
芩	千 器 琴 勤 侵 秦 邻 寝 氢 锌 钦 禽 沁 糗 旻
髻	己 计 级 及 集 即 急 激 纪 继 鸡 吉 肌 挤 忌
狰	重 正 证 政 整 省 争 涨 征 震 郑 症 忠 挣 蒸
缨	应 影 英 硬 映 赢 盈 颖 婴 鹰 樱 莹 荧 蝇 萤
柘	这 着 者 设 折 喆 哲 浙 遮 煮 殖 辙 褶 辄 蔗
绡	小 笑 消 销 效 漂 晓 孝 肖 萧 削 宵 潇 衔 嚣
貅	修 秀 休 旧 羞 媳 仇 锡 袖 绣 昔 膝 钮 锈 朽
杼	主 住 助 祝 筑 猪 逐 珠 竹 驻 柱 煮 丶 烛 株
醍	体 题 提 毕 替 梯 踢 剔 屄 蚁 惕 蹄 涕 剃 嚏
谀	于 预 遇 域 余 雨 宇 愉 郁 愚 寓 豫 裕 逾 瑜
邳	批 皮 屁 脾 疲 匹 披 啤 劈 癖 坯 霹 琵 毗 媲
鲲	论 运 困 均 寻 允 夸 晕 昆 坤 屯 捆 汛 昀 珺
皑	爱 继 哎 艾 唉 碍 埃 欸 挨 哀 晰 癌 矮 暧 吏
饷	想 相 像 强 向 象 项 讲 响 香 享 乡 箱 详 翔
嘹	连 销 料 恋 聊 疗 漂 炼 吊 孝 辽 肖 郊 撩 饺
雎	车 具 局 举 巨 距 拒 俱 惧 拘 矩 菊 橘 狙 驹
珩	望 航 忘 杭 昂 狼 丈 芳 脏 荒 洪 虹 恍 琅 乓
谟	模 默 魔 末 摩 莫 磨 摸 膜 墨 陌 脉 寞 抹 漠
趸	论 独 困 损 顿 盾 敦 逊 裙 吨 蹲 捆 囤 舵 笋
硚	千 巧 桥 焦 乔 歉 敲 喵 悄 瞧 雀 嵌 侨 翘 俏
咛	清 星 精 宁 苹 倾 赢 刑 凝 坪 卿 菱 擎 璟 柠
筵	验 严 烟 颜 炎 艳 燕 盐 沿 岩 掩 宴 咽 衍 腌
尕	哪 该 格 它 干 达 巴 孤 扒 葛 塌 尬 疤 膏 噶
仃	定 东 清 顶 订 镜 净 丁 凭 鼎 颈 钉 盯 冥 叮
暻	经 京 景 警 惊 竞 镜 净 敬 径 晶 井 颈 荆 靖
潸	产 山 善 删 闪 扇 陕 擅 衫 珊 杉 汕 姗 煽 讪
胛	家 加 价 假 酒 佳 架 驾 甲 嘉 嫁 夹 贾 迦 钾
醐	户 护 互 乎 湖 呼 胡 虎 忽 糊 狐 沪 壶 蝴 葫
蚱	制 找 查 差 志 珠 咋 扎 炸 渣 诈 罩 闸 榨 眨
徇	婚 军 训 询 寻 讯 迅 循 巡 逊 旬 勋 熏 绚 驯
孪	乱 幻 缘 圆 卷 冠 链 缓 炼 览 烂 怨 泉 懒 篮
阆	放 龙 浪 洋 钢 朗 昂 隆 粮 狼 芳 郎 痒 沧 廊
阈	于 预 遇 域 余 雨 宇 愉 郁 愚 寓 豫 裕 逾 瑜
胗	真 镇 针 珍 圳 震 阵 诊 振 侦 甄 帧 疹 臻 朕
崃	来 海 利 孩 带 累 兰 灾 泪 勒 赖 莱 挨 唻 佰
蜿	完 万 玩 晚 湾 弯 碗 挽 塆 丸 婉 顽 腕 榄 宛
黝	友 又 游 由 优 油 右 邮 尤 幼 忧 幽 悠 犹 诱
啕	套 讨 淘 泰 逃 浩 妖 炮 桃 陶 涛 萄 掏 谭 茂
窈	要 约 药 讨 摇 邀 腰 妖 耀 遥 咬 谣 岆 瑶 姚
聿	于 预 遇 域 余 雨 宇 愉 郁 愚 寓 豫 裕 逾 瑜
蚩	吃 持 迟 池 尺 赤 痴 驰 齿 耻 斥 侈 翅 炽 痣
颚	哦 额 恶 俄 呃 饿 鹅 噩 厄 鄂 遏 娥 讹 扼 胺
鼾	航 汉 韩 含 寒 涵 喊 汗 憾 函 撼 氨 旱 晗 焊
绔	付 足 句 苦 库 哭 酷 宿 咯 屋 欲 裤 狱 腹 雾
嘣	并 仍 碰 萌 衡 崩 猛 彭 蚌 蹦 泵 耿 柄 懵 绷
鄢	验 严 烟 颜 炎 艳 燕 盐 沿 岩 掩 宴 咽 衍 腌
睽	快 鬼 嘴 哭 挥 亏 轨 馈 愧 溃 葵 窥 盔 魁 奎
颧	全 权 券 缓 欠 怨 泉 劝 拳 炫 玄 犬 劵 诠 媛
荥	行 性 并 星 形 型 兴 幸 醒 映 欣 姓 刑 盈 馨
鳍	其 七 气 妻 戚 棋 琦 凄 祁 麒 迄 杞 祺 亟 岐
囱	从 童 藏 综 聪 贡 洪 恭 葱 匆 丛 哄 沧 烘 耸
砭	变 先 见 边 编 遍 辩 滨 莲 辨 贬 鞭 帘 黏 缅
逵	快 鬼 嘴 哭 挥 亏 轨 馈 愧 溃 葵 窥 盔 魁 奎
佯	样 养 阳 党 杨 央 棒 洋 扬 羊 仰 氧 旸 痒 烊
搡	商 往 伤 扬 绑 杭 旺 丧 纲 桑 趟 芒 沧 廊 嗓
毽	间 见 简 检 监 键 剑 尖 浅 剪 艰 肩 舰 奸 箭
罡	刚 港 访 央 棒 钢 攻 岗 杭 仰 纲 杠 旸 纺 庞
鞑	大 打 单 度 达 答 呀 搭 罚 娜 涯 哒 稻 嗒 睹
谄	产 春 察 朝 串 憾 缠 擅 阐 禅 馋 珊 蝉 湛 掺
绾	完 万 玩 晚 湾 弯 碗 挽 塆 丸 婉 顽 腕 宛 檀
杷	普 亚 怕 扒 爬 砸 披 泼 祂 啪 葩 帕 哑 靶 鸦
枇	批 皮 屁 脾 疲 匹 披 啤 劈 癖 坯 霹 琵 毗 媲
珅	身 神 深 称 申 审 甚 沈 尘 伸 慎 肾 渗 汕 绅
揄	于 预 遇 域 余 雨 宇 愉 郁 愚 寓 豫 裕 逾 瑜
霁	己 计 级 及 集 即 急 激 继 鸡 吉 肌 挤 忌 羁
湍	原 院 选 元 团 软 摊 援 旋 贯 贪 纶 眷 臀 渲
揩	开 待 卖 态 载 牌 财 排 拍 害 嘅 凯 溃 慨 狸
辊	故 军 冠 滚 灌 浑 雇 昏 坤 硅 罐 刮 吨 棍 卦
蜊	理 里 力 利 历 励 厉 厘 璃 哩 荔 吏 篱 鲤 俐
湎	面 联 线 免 贤 垫 眠 肩 歉 莲 廉 棉 绵 勉 缅
敝	比 笔 币 避 闭 鼻 彼 壁 碧 鄙 弊 辟 臂 屄 毙
鹑	产 准 春 穿 陈 纯 混 晨 魂 蠢 唇 锤 喘 蝉 橱
菅	件 见 简 检 坚 健 监 键 浅 剪 肩 舰 奸 煎 捡
囿	友 又 游 由 优 油 右 邮 尤 幼 忧 幽 悠 犹 诱
搔	包 暴 遭 稿 扫 遥 恼 骚 钥 嫂 嚎 敖 皂 幺 祷
揶	也 业 夜 爷 野 页 叶 予 娱 隔 液 耶 椰 冶 噎
旖	意 已 义 医 移 仪 伊 谊 疫 毅 椅 溢 怡 祎 颐
墉	用 东 永 拥 勇 虹 庸 婴 泳 涌 笼 佣 痒 溶 咏
旎	你 际 尼 忆 拟 敌 泥 逆 妮 埃 腻 伱 倪 霓 匿
镊	结 呢 姐 届 杰 烈 截 捷 灭 邪 妮 憋 捏 孽 聂
邝	款 况 黄 康 狂 皇 矿 逛 框 凰 晃 恍 旷 惶 匡
谥	什 实 师 试 世 视 式 使 失 识 示 士 适 室 湿
桧	回 惠 汇 慧 悔 辉 徽 毁 恢 贿 讳 卉 晖 晦 荟
伫	主 住 助 祝 筑 猪 逐 珠 竹 驻 柱 煮 丶 烛 株
珺	军 均 尊 伦 混 君 俊 允 锦 敦 菌 逊 裙 骏 峻
蜢	等 名 梦 腾 盟 蒙 疯 萌 猛 孟 泵 蹭 懵 绷 凳
郜	高 告 搞 貌 毫 泡 澳 冒 郭 傲 稿 糕 膏 镐 皋
觐	进 金 今 近 极 尽 仅 紧 津 禁 劲 斤 锦 谨 晋
婀	哦 额 恶 俄 呃 饿 鹅 噩 厄 鄂 遏 娥 讹 扼 胺
瞑	明 名 影 民 请 并 命 病 兵 迎 睛 鸣 铭 鹰 冥
钴	股 故 古 顾 估 鼓 固 孤 姑 谷 雇 辜 菇 咕 沽
唷	游 预 遇 移 亚 爷 摩 牙 哟 脉 遥 涡 抹 酉 逾
绉	周 州 洲 猪 逐 奏 猴 煮 宙 舟 骤 轴 咒 粥 皱
懋	报 号 毛 爆 猫 贸 貌 澳 冒 矛 帽 茅 冇 茂 壕
疸	但 单 待 验 半 担 蛋 淡 丹 旦 胆 诞 耽 拦 氮
璜	黄 床 皇 荒 凰 谎 慌 霜 煌 晃 恍 焕 惶 簧 潢
馀	于 育 鱼 予 欲 郁 愈 寓 浴 御 裕 於 逾 瑜 虞
冼	现 限 险 显 县 鲜 闲 陷 嫌 贤 羡 咁 纤 弦 宪
幄	我 午 破 握 澳 卧 窝 污 沃 涡 喔 倭 蜗 舶 诬
熵	上 场 常 商 声 唱 省 伤 航 厂 尚 胜 赏 杭 霜
邕	用 永 拥 勇 虹 庸 婴 泳 涌 笼 佣 痒 溶 咏 雍
芎	想 行 相 像 向 享 醒 乡 箱 兄 姓 雄 熊 胸 祥
掳	路 录 陆 绿 鲁 鹿 炉 卢 撸 芦 璐 卤 庐 禄 噜
俸	风 份 曾 登 丰 封 峰 疼 疯 凤 锋 奉 坊 缝 蜂
鲅	吧 八 把 爸 呀 播 巴 薄 拔 芭 罢 怖 叭 祂 弊
鹌	安 完 班 干 演 案 按 暗 蛮 胆 甘 岸 俺 氨 鞍
痤	活 错 获 措 惑 夺 哆 挫 裹 翠 豁 醋 嗦 搓 璀
旌	经 京 景 警 静 竞 镜 净 径 晶 井 颈 荆 靖 璟
窕	调 条 淘 跳 挑 苗 轿 侨 寥 恬 嫖 婊 廖 窖 淆
彧	于 育 鱼 予 欲 郁 愈 寓 浴 御 裕 於 逾 瑜 虞
砣	推 讨 索 托 脱 锁 拖 拓 陶 妥 魄 陀 驼 唾 糯
倜	体 题 提 毕 替 梯 踢 剔 蚁 惕 蹄 涕 剃 疵 嚏
纰	批 皮 屁 脾 疲 匹 披 啤 劈 癖 坯 霹 琵 毗 媲
楹	应 影 英 营 迎 硬 映 赢 盈 颖 婴 鹰 樱 莹 荧
碜	称 陈 诚 沉 珍 晨 沈 撑 尘 狠 振 辰 臣 痕 趁
麝	设 社 适 势 摄 舍 射 涉 彻 氏 吓 厦 蛇 奢 舌
笺	间 件 建 检 监 荐 键 践 尖 浅 剪 肩 舰 奸 箭
雉	之 知 只 直 质 值 智 枝 脂 汁 吱 秩 稚 蜘 炙
岫	修 秀 休 旧 羞 媳 仇 锡 袖 绣 昔 膝 钮 锈 朽
箕	己 计 级 及 集 即 急 激 纪 继 鸡 吉 挤 忌 祭
伢	亚 呀 压 雅 牙 押 涯 鸭 丫 吖 芽 榆 讶 哑 鸦
轱	股 故 古 顾 估 鼓 固 骨 孤 姑 谷 雇 辜 菇 咕
锹	巧 桥 鸟 乔 敲 悄 瞧 雀 嵌 侨 翘 俏 掐 窍 撬
樽	论 座 群 寻 罪 讯 轮 尊 祖 君 迅 遵 浑 坤 囤
艮	很 身 婚 温 恩 魂 盒 恒 恨 荷 狠 愤 辰 伸 贺
鲶	年 片 边 念 偏 填 仙 莲 殿 遣 铅 掂 碱 敛 黏
膈	个 格 歌 各 哥 河 刻 夜 核 喝 革 估 隔 割 戈
醚	极 米 密 迷 秘 蜜 弥 咪 谜 幂 裔 泌 靡 觅 眯
镌	管 件 款 端 圈 卷 泉 浅 捐 玄 犬 劵 倦 娟 眷
蛔	回 惠 汇 慧 悔 辉 徽 毁 恢 贿 讳 卉 晖 晦 荟
燮	些 解 谢 写 鞋 械 邪 谐 蟹 携 泄 蝎 歇 卸 胁
陟	之 知 只 直 质 值 智 枝 脂 汁 吱 秩 稚 蜘 炙
荃	获 楚 纯 炒 措 惑 吵 挫 豁 锤 戳 雏 淳 烁 辍
稞	可 科 客 课 克 刻 哭 颗 渴 壳 柯 磕 棵 苛 坷
唢	所 错 苏 索 锁 缩 洛 措 惑 夺 扫 霍 琐 嫂 琢
麾	回 惠 汇 慧 悔 辉 徽 毁 恢 贿 讳 卉 晖 晦 荟
哐	光 广 况 狂 矿 框 谎 慌 煌 扛 旷 匡 簧 慷 潢
忖	论 错 运 存 村 困 均 寻 惨 催 寸 循 昆 醇 搓
荠	其 期 七 器 妻 戚 棋 琦 凄 祁 绮 麒 柒 杞 祺
朐	去 区 取 诉 曲 趣 欲 促 幅 趋 驱 屈 渠 娶 躯
馊	由 楼 优 首 投 搜 鼠 猴 兜 署 肃 抖 嗽 艘 鱿
蟀	说 水 华 税 睡 怀 坏 刷 帅 晒 耍 衰 摔 甩 淮
铰	教 交 校 较 叫 角 脚 缴 焦 胶 娇 骄 矫 搅 蕉
傥	统 藏 堂 唐 糖 汤 摊 芳 郎 躺 塘 趟 烫 冈 秧
弭	极 米 密 迷 秘 蜜 弥 咪 谜 幂 裔 泌 靡 觅 眯
炔	越 确 决 且 却 切 缺 屈 诀 崛 茄 靴 妾 怯 瘸
蜉	节 写 列 铁 烈 裂 猎 劣 咧 膊 喱 亵 砺 凛 拮
钎	前 钱 千 潜 迁 牵 歉 谦 遣 铅 乾 倩 嵌 谴 黔
晁	照 超 朝 插 潮 炒 拆 吵 抄 嘲 阐 罩 巢 爪 钞
蜃	身 神 深 称 申 审 甚 舍 沈 尘 瞬 伸 慎 肾 渗
谲	觉 决 绝 介 跃 俱 掘 爵 曰 穴 诀 崛 抉 倔 厥
旯	马 历 离 拉 啦 俩 垃 辣 叻 梨 蜡 腊 喇 锕 耙
誊	等 听 风 腾 盟 疼 邓 廷 霆 讽 棚 蚌 藤 愣 亨
茯	服 付 父 富 府 附 妇 符 幅 肤 傅 抚 弗 辐 俯
郧	员 运 云 颜 孕 允 晕 韵 裙 蕴 匀 芸 酝 耘 陨
囵	论 轮 绿 损 伦 混 逻 允 菌 逊 裙 旬 拦 沦 仑
滓	自 子 字 咨 仔 紫 姿 兹 孜 籽 淄 梓 疵 呲 渍
耒	类 累 陪 雷 泪 勒 蕾 磊 贼 妃 诶 嗨 蔚 昧 垒
汩	股 故 古 顾 估 鼓 固 骨 孤 姑 谷 雇 辜 菇 咕
洵	选 宣 旋 悬 暅 炫 玄 轩 萱 喧 渲 绚 璇 嬛 眩
疝	山 善 删 闪 憾 扇 陕 擅 衫 珊 杉 汕 姗 煽 讪
狍	套 跑 岛 泡 糕 扫 炮 抛 曝 葩 攀 拌 唠 袍 韬
叵	被 破 婆 摩 霸 屁 坡 抹 颇 泼 渤 袍 珀 陂 茉
蟋	西 喜 习 吸 媳 晰 稀 溪 夕 兮 茜 犀 烯 熄 嬉
馗	快 鬼 嘴 哭 亏 阔 馈 愧 溃 摧 葵 窥 盔 魁 奎
鹂	理 里 力 利 历 励 厉 厘 璃 哩 荔 吏 篱 鲤 俐
侑	友 又 游 由 优 油 右 邮 幼 忧 幽 悠 犹 诱 呦
炀	样 养 阳 杨 央 棒 洋 扬 羊 仰 氧 旸 痒 烊 秧
谌	身 神 深 称 申 审 甚 舍 沈 尘 瞬 伸 慎 肾 渗
砒	批 皮 屁 脾 疲 匹 披 啤 劈 癖 坯 霹 琵 毗 媲
飕	由 楼 优 首 投 搜 鼠 猴 兜 署 肃 抖 嗽 艘 鱿
诌	周 州 洲 猪 逐 奏 猴 煮 宙 舟 骤 轴 咒 粥 皱
痢	理 里 力 利 历 励 厉 厘 璃 哩 荔 吏 篱 鲤 俐
髋	快 原 院 算 款 狂 宽 缘 夸 援 劝 框 拳 昆 倦
盱	需 许 续 须 序 虚 绪 徐 蓄 叙 旭 畜 絮 恤 婿
麋	米 密 迷 秘 蜜 弥 咪 谜 幂 裔 溺 泌 靡 觅 眯
蹙	顾 族 舞 鱼 促 粗 崔 逾 瑜 芦 凸 醋 妒 吾 舆
驸	父 负 富 府 夫 附 浮 扶 伏 覆 敷 芙 辐 阜 孵
萼	哦 额 恶 俄 呃 饿 鹅 噩 厄 鄂 遏 娥 讹 扼 胺
蕨	觉 决 绝 介 跃 掘 爵 曰 穴 诀 崛 抉 倔 厥 獗
灞	吧 八 把 爸 呀 巴 拔 芭 罢 怖 叭 祂 弊 啪 疤
黠	下 西 喜 消 夏 俩 侠 瞎 霞 萧 虾 辖 峡 狭 屑
饴	意 已 义 医 移 仪 伊 谊 疫 毅 椅 溢 怡 祎 颐
痱	费 非 飞 伟 肥 菲 废 啡 肺 妃 匪 沸 绯 嘞 翡
胫	梦 增 肯 控 曾 层 坑 捧 鹏 冯 扔 孟 逢 绷 凳
衮	故 军 冠 滚 浑 雇 昏 坤 硅 罐 刮 吨 棍 卦 吞
弼	比 毕 笔 币 避 闭 鼻 彼 壁 碧 鄙 弊 臂 屄 庇
洮	早 造 套 讨 淘 邀 逃 桃 陶 涛 稻 捣 萄 掏 苞
唛	吗 妈 马 码 亚 米 嘛 麻 猫 骂 玛 涯 祂 啪 靶
焘	早 造 套 讨 淘 邀 逃 桃 陶 涛 稻 捣 萄 掏 苞
楣	没 美 费 每 妹 媒 梅 煤 魅 眉 玫 霉 枚 昧 媚
砧	真 镇 针 珍 圳 震 阵 诊 振 侦 甄 帧 疹 臻 朕
饯	间 件 简 检 健 监 荐 键 践 浅 剪 舰 奸 箭 煎
甯	平 影 请 青 病 宁 硬 竞 龄 晶 井 凝 莹 聆 憬
眙	等 登 顶 灯 盟 疼 蒙 邓 缝 蜂 捧 鹏 橙 澄 翁
榛	真 镇 针 珍 圳 震 阵 诊 振 侦 甄 帧 疹 臻 朕
豺	海 孩 吃 持 炒 池 拆 吵 抄 尺 摘 叉 柴 阐 铲
囫	户 护 互 乎 湖 呼 胡 虎 忽 糊 沪 壶 蝴 葫 弧
彳	吃 持 迟 池 尺 赤 痴 驰 齿 耻 斥 侈 翅 炽 嗤
镣	消 销 料 恋 聊 疗 漂 炼 吊 辽 肖 郊 撩 饺 寥
堇	进 金 今 近 极 尽 仅 紧 津 禁 劲 斤 锦 谨 晋
舛	换 环 穿 川 赚 床 船 串 砖 蠢 禅 喘 醇 揣 栓
龋	去 区 取 曲 土 趣 趋 驱 屈 渠 辱 娶 躯 佢 祛
锺	中 种 长 重 总 终 众 钟 征 忠 帐 仲 肿 衷 弘
跄	相 两 强 亲 响 香 庆 抢 穷 凉 枪 墙 腔 遣 铅
迤	意 已 义 医 移 仪 伊 谊 疫 毅 椅 溢 怡 祎 颐
郓	员 院 运 云 颜 孕 允 晕 韵 蕴 匀 芸 酝 耘 陨
砀	当 党 档 唐 荡 仰 昂 挡 桑 纺 庞 痒 瞪 壤 莽
踉	两 量 领 亮 练 良 辆 梁 凉 枪 粮 谅 岭 靓 巷
呓	意 已 义 医 移 仪 伊 谊 疫 毅 椅 溢 怡 祎 颐
嵇	计 级 及 集 即 急 激 纪 继 鸡 吉 挤 忌 祭 姬
靥	也 业 夜 爷 亿 野 页 叶 宇 予 液 耶 椰 冶 噎
氙	现 先 限 险 显 县 鲜 仙 陷 嫌 贤 羡 咁 纤 弦
蝣	友 又 游 由 优 油 右 邮 幼 忧 幽 悠 犹 诱 呦
鹈	体 题 提 毕 替 梯 踢 剔 屄 蚁 玺 惕 蹄 涕 剃
牦	报 毛 爆 猫 贸 貌 冒 矛 糕 苗 帽 茅 冇 茂 壕
铤	平 影 听 挺 停 庭 冰 宁 厅 镜 腾 铃 婷 亭 廷
琨	论 询 困 跨 孕 君 昆 巡 阔 坤 蕴 葵 捆 阚 遁
殓	联 连 练 恋 脸 链 炼 怜 莲 廉 辨 帘 敛 拣 娴
菡	担 汉 韩 淡 含 寒 涵 喊 汗 憾 函 撼 旱 晗 焊
瓴	零 领 另 灵 令 龄 凌 玲 铃 陵 岭 菱 聆 伶 拎
竽	于 预 遇 域 余 雨 宇 愉 郁 愚 寓 豫 裕 逾 瑜
澧	理 里 力 利 历 励 厉 厘 璃 哩 荔 吏 篱 鲤 俐
鹕	户 护 互 乎 湖 呼 胡 虎 忽 糊 狐 沪 壶 蝴 葫
麸	父 负 富 府 夫 附 浮 扶 伏 覆 芙 辐 阜 孵 俘
肱	工 公 东 从 功 共 供 攻 恐 宫 贡 恭 泳 踪 鸿
诨	论 婚 护 获 混 虎 挥 润 魂 憾 晕 沪 浑 昏 匀
牒	写 界 跌 敌 捷 灭 爹 蝶 碟 叠 鳎 谍 咩 缔 迭
萋	其 期 七 气 器 妻 戚 棋 琦 凄 祁 绮 麒 杞 祺
臾	于 预 遇 域 余 雨 宇 愉 郁 愚 寓 豫 裕 逾 瑜
咂	再 哪 早 造 麻 杂 咱 牙 挖 拔 槽 炸 押 芭 砸
耄	报 毛 爆 猫 贸 貌 冒 矛 糕 苗 帽 茅 冇 茂 壕
扦	前 钱 千 潜 迁 牵 歉 谦 遣 铅 乾 倩 嵌 谴 黔
郦	理 里 力 利 历 励 厉 厘 璃 哩 荔 吏 篱 鲤 俐
氦	还 哈 海 号 孩 害 择 毫 艾 嘿 哀 晒 宅 咳 翰
溟	米 密 迷 秘 蜜 眉 弥 咪 谜 幂 裔 溺 泌 靡 觅
罘	父 负 富 府 夫 附 妇 浮 扶 伏 覆 芙 辐 阜 孵
踽	车 局 居 举 聚 距 拒 俱 惧 矩 菊 橘 狙 鞠 驹
玧	员 运 云 雨 孕 允 晕 韵 蕴 匀 芸 酝 耘 峪 陨
羸	联 连 练 恋 脸 链 炼 怜 莲 廉 辨 帘 敛 拣 娴
匍	普 欲 铺 吐 辅 污 谱 悟 驱 扑 浦 葡 菩 埔 仆
粳	更 登 港 疼 岗 蒙 疯 缝 蜂 耕 梗 庚 巩 枫 翁
哏	更 跟 干 根 敢 闻 革 仁 隔 纷 氛 狠 嫩 粪 焚
捌	吧 八 把 爸 播 巴 薄 拔 芭 罢 涯 怖 叭 祂 弊
夔	随 鬼 嘴 哭 亏 阔 馈 愧 溃 葵 窥 盔 魁 奎 匮
珐	发 法 服 亚 怕 饭 附 罚 乏 伏 覆 伐 祂 阀 哑
耋	写 界 跌 敌 捷 灭 爹 蝶 碟 叠 鳎 谍 咩 缔 迭
邡	方 放 房 养 往 防 访 仿 芳 脏 挡 坊 妨 逢 杠
钯	普 亚 怕 扒 爬 披 泼 祂 啪 葩 帕 哑 靶 鸦 趴
佻	调 条 脚 淘 跳 挑 辽 悄 钓 撩 寥 嫖 婊 刁 缪
蝼	六 流 楼 否 录 露 豆 陆 扣 逗 漏 炉 喽 苟 陋
偻	利 路 律 率 旅 虑 垃 辣 侣 履 吕 芦 滤 驴 铝
綦	其 期 七 气 器 妻 戚 棋 琦 凄 祁 麒 杞 祺 亟
醴	理 里 力 利 历 励 厉 厘 璃 哩 荔 吏 篱 鲤 俐
拚	品 片 音 尽 频 临 拼 贫 淋 潘 匹 鑫 叛 钦 沁
缙	进 金 今 近 极 尽 仅 紧 津 禁 劲 斤 锦 谨 晋
羟	相 两 强 响 庆 抢 梁 凉 枪 墙 谅 腔 遣 铅 呛
侪	海 孩 吃 持 炒 池 拆 吵 抄 尺 摘 叉 柴 阐 铲
匐	父 负 富 府 夫 附 妇 浮 扶 伏 覆 芙 辐 阜 孵
颛	专 转 传 换 穿 状 川 赚 船 钻 撞 串 砖 唤 粘
橇	巧 桥 乔 敲 喵 悄 瞧 雀 嵌 侨 翘 俏 掐 硝 窍
褓	保 报 包 宝 抱 爆 暴 薄 邀 饱 堡 恼 剥 胞 曝
郅	之 知 只 直 质 值 智 枝 脂 汁 吱 秩 稚 蜘 炙
茏	总 龙 弄 董 孔 凌 隆 涌 笼 垄 拢 珑 聋 伶 胧
鳕	学 月 血 缺 雪 虚 跃 蟹 循 玥 薛 穴 靴 噱 汛
腓	费 非 飞 肥 菲 废 卑 啡 肺 妃 匪 沸 绯 嘞 猥
幔	满 谈 范 慢 漫 贸 蛮 曼 番 埋 滥 婉 谭 衍 瞒
薅	好 海 号 药 豪 潮 貌 毫 傲 耗 浩 凹 烤 嚎 昊
铵	安 完 班 干 演 案 按 暗 蛮 胆 甘 岸 俺 氨 鞍
鲈	路 录 陆 绿 鲁 鹿 炉 卢 碌 撸 芦 璐 禄 噜 泸
苡	意 已 义 医 移 忆 仪 伊 谊 疫 毅 椅 溢 怡 祎
垛	多 毒 郭 夺 朵 哆 躲 堕 稻 捣 螺 叨 怼 剁 搓
襁	相 两 强 响 庆 抢 梁 凉 枪 墙 谅 腔 遣 铅 呛
苋	现 先 限 险 显 县 鲜 闲 仙 陷 嫌 贤 羡 咁 纤
孱	产 春 察 朝 串 憾 缠 擅 阐 禅 馋 珊 蝉 湛 掺
哙	开 快 块 怪 乖 慨 淮 拐 楷 窥 恺 筷 盔 魁 匮
訇	容 红 聪 恒 宏 宠 哼 隆 贡 洪 虹 鸿 轰 哄 弘
聒	国 过 果 规 锅 锁 郭 洛 措 稿 惑 裹 撮 咕 铎
赳	就 九 究 酒 久 救 旧 纠 仇 舅 揪 玖 韭 灸 钮
厩	就 九 究 酒 久 救 旧 纠 仇 舅 揪 玖 韭 灸 钮
钼	目 母 顾 麻 鱼 木 幕 慕 姆 牧 墓 募 敷 瑜 谜
芾	费 非 飞 肥 菲 废 卑 啡 肺 妃 匪 沸 绯 嘞 猥
魍	网 当 完 望 王 往 忘 藏 访 央 棒 亡 仰 旺 汪
葭	下 西 喜 消 夏 侠 瞎 霞 萧 虾 辖 峡 狭 屑 暇
诘	接 结 界 姐 介 街 借 截 揭 捷 戒 皆 劫 羯 桔
埂	更 登 港 疼 蒙 疯 缝 蜂 耕 梗 庚 巩 枫 翁 耿
璎	应 影 英 硬 映 赢 盈 颖 婴 鹰 樱 莹 荧 蝇 萤
咲	小 调 笑 消 销 效 晓 瞎 孝 肖 萧 削 宵 潇 嚣
啜	活 储 吹 措 桌 惑 祸 嘲 蠢 垂 戳 醇 搓 烁 锄
枞	通 总 终 综 荣 宗 孔 隆 纵 踪 巩 瞳 咚 盅 嵩
氲	员 运 云 孕 允 晕 韵 裙 蕴 匀 嫣 芸 酝 耘 陨
硪	我 午 破 握 澳 卧 窝 污 沃 涡 喔 勃 倭 蜗 诬
捱	爱 继 哎 艾 唉 碍 埃 欸 挨 哀 晰 癌 矮 暧 吏
龅	套 跑 岛 泡 糕 扫 炮 抛 曹 曝 葩 攀 拌 唠 袍
佝	候 够 购 构 狗 沟 奏 勾 雇 钩 苟 釉 逅 垢 鸥
苣	车 局 居 举 聚 距 拒 俱 惧 矩 菊 焗 橘 狙 鞠
呤	零 领 另 灵 令 龄 凌 玲 铃 陵 岭 菱 聆 伶 拎
耷	大 打 哈 达 读 马 答 巴 压 岛 搭 渡 哒 塌 嗒
藁	高 告 搞 貌 泡 澳 冒 郭 傲 甘 稿 糕 膏 镐 皋
藿	活 或 货 火 获 伙 悔 缩 郭 惑 裸 霍 祸 豁 陀
怄	族 舞 鱼 木 苏 欧 偶 喽 酉 敷 瑜 喉 芦 钩 殴
菀	员 运 云 孕 允 寸 晕 韵 蕴 匀 嫣 芸 酝 耘 陨
氤	因 音 研 银 引 印 阴 隐 饮 姻 淫 瘾 吟 殷 尹
魉	两 量 联 香 另 享 亮 良 娘 链 辆 梁 凉 粮 怜
珲	回 惠 汇 挥 慧 灰 辉 徽 毁 绘 贿 讳 卉 晖 晦
嵋	没 美 费 每 妹 媒 梅 煤 魅 眉 玫 霉 枚 昧 媚
鸨	保 报 包 宝 抱 爆 暴 薄 邀 饱 堡 恼 剥 胞 曝
酞	太 白 台 态 探 哎 泰 胎 桃 挨 哀 摊 抬 汰 毯
聩	快 哭 挥 亏 轨 馈 愧 溃 葵 窥 盔 魁 奎 匮 傀
肓	黄 皇 荒 框 凰 谎 慌 煌 晃 恍 焕 惶 簧 潢 徨
燊	身 神 深 称 申 审 甚 舍 沈 尘 伸 慎 肾 渗 汕
逶	微 未 围 卫 威 唯 尾 薇 魏 畏 蔚 巍 惟 潍 纬
藜	理 里 力 利 历 励 厉 厘 璃 哩 荔 吏 篱 鲤 俐
犄	己 计 级 及 集 即 急 激 纪 继 鸡 吉 挤 忌 祭
蕲	七 器 弃 妻 欺 骑 契 漆 琪 崎 祁 麒 迄 杞 亟
宓	极 米 密 迷 秘 蜜 眉 弥 咪 谜 幂 裔 泌 靡 觅
浠	西 喜 习 吸 媳 晰 稀 溪 夕 兮 茜 犀 烯 熄 嬉
刍	出 吃 处 初 除 楚 础 触 储 筹 池 厨 唇 橱 雏
桉	安 完 班 干 演 案 按 暗 蛮 胆 甘 岸 俺 氨 鞍
瘘	六 流 楼 否 录 露 豆 陆 扣 偶 漏 炉 喽 苟 陋
蓥	应 影 英 迎 硬 映 赢 盈 颖 鹰 樱 莹 荧 蝇 萤
鸩	真 镇 针 珍 圳 震 阵 诊 侦 甄 枕 帧 疹 臻 朕
掸	产 战 春 偿 串 缠 柴 唇 阐 禅 沾 馋 蝉 掺 铲
獠	销 料 恋 聊 疗 漂 炼 孝 辽 雕 肖 郊 撩 饺 寥
剌	马 历 离 拉 啦 咯 俩 垃 辣 唻 叻 梨 蜡 腊 喇
悱	费 非 飞 肥 菲 废 啡 肺 妃 匪 沸 绯 嘞 猥 翡
遑	黄 皇 荒 凰 谎 慌 煌 晃 恍 焕 惶 簧 潢 徨 筐
犸	吗 妈 马 码 亚 怕 米 嘛 麻 猫 骂 玛 涯 祂 啪
鸪	股 古 顾 估 鼓 固 骨 孤 姑 谷 雇 辜 菇 咕 沽
豇	相 两 将 京 讲 江 奖 降 娘 枪 晶 粮 疆 舰 姜
巽	训 询 寻 讯 迅 循 巡 逊 旬 勋 熏 驯 薰 歆 浚
陲	回 触 吹 恢 尺 催 厨 垂 侈 崔 锤 橱 晖 赘 晦
娌	理 里 力 利 历 励 厉 厘 璃 哩 荔 吏 篱 鲤 俐
桠	亚 呀 压 异 雅 牙 押 涯 鸭 丫 吖 芽 榆 讶 哑
鲑	妈 它 达 马 吴 娃 挖 哇 瓦 鸭 叭 雾 爬 喔 袜
歙	书 设 社 适 室 摄 舍 射 涉 沈 厦 暑 蛇 奢 舌
庖	套 跑 岛 泡 糕 扫 炮 抛 曹 曝 葩 攀 唠 袍 韬
睨	你 李 笔 尼 拟 泥 逆 唉 姨 妮 腻 伱 倪 霓 匿
鹧	这 着 者 折 喆 哲 浙 遮 煮 殖 辙 褶 辄 蔗 啫
钏	环 穿 川 赚 床 船 缓 串 砖 蠢 禅 喘 醇 揣 栓
滢	应 影 英 迎 硬 映 赢 盈 颖 鹰 樱 莹 荧 蝇 萤
嗬	和 合 何 课 呵 河 核 喝 呼 射 盒 荷 吓 赫 贺
氩	亚 呀 压 异 夜 雅 牙 押 涯 鸭 丫 吖 芽 讶 哑
蛭	之 知 只 直 质 值 智 枝 脂 汁 吱 秩 稚 蜘 酯
萸	于 预 遇 域 余 雨 宇 愉 郁 愚 寓 豫 裕 逾 瑜
牍	都 度 读 独 顾 毒 督 杜 赌 肚 渡 堵 吨 妒 嘟
鲟	训 询 寻 讯 迅 循 巡 逊 旬 勋 熏 靴 锌 驯 薰
妯	周 州 洲 祝 守 猪 逐 珠 竹 酬 猴 宙 舟 骤 轴
锆	高 告 搞 貌 泡 澳 冒 郭 傲 甘 稿 糕 膏 镐 皋
觞	上 场 常 商 声 唱 省 伤 航 厂 尚 胜 赏 帐 杭
苜	目 母 顾 舞 麻 鱼 木 幕 慕 姆 牧 墓 募 瑜 谜
赓	更 登 港 疼 蒙 疯 缝 蜂 耕 梗 庚 巩 枫 翁 耿
郯	谈 范 慢 弹 探 坛 坦 摊 贪 叹 碳 滩 炭 谭 潭
吡	被 批 皮 屁 脾 疲 匹 啤 劈 癖 坯 霹 琵 毗 媲
靼	大 打 哈 达 读 马 答 巴 岛 搭 渡 哒 塌 嗒 讶
邈	校 猫 脚 描 妙 秒 飘 苗 帽 辽 喵 庙 蕉 撩 飙
啮	结 姐 届 杰 烈 截 捷 灭 邪 妮 憋 捏 孽 聂 邂
腭	哦 恶 俄 呃 饿 鹅 噩 厄 鄂 遏 娥 讹 扼 胺 峨
糍	自 子 资 字 咨 仔 紫 姿 滋 兹 籽 淄 梓 疵 呲
砗	河 陈 扯 彻 撤 吓 尘 尺 厨 澈 矗 嗤 蔗 褚 忱
跛	被 破 婆 摩 霸 屁 坡 抹 颇 泼 倭 袍 珀 陂 茉
磲	去 区 取 曲 土 趣 趋 驱 屈 渠 辱 娶 躯 佢 祛
掬	车 局 居 举 聚 距 俱 惧 矩 菊 焗 橘 狙 鞠 驹
绻	全 原 权 签 券 泉 援 旋 贯 劝 拳 犬 诠 钳 窜
膑	音 近 边 遍 避 欣 宾 滨 饼 辨 谨 斌 彬 尹 昕
岀	出 处 初 除 楚 础 触 储 池 厨 丶 橱 雏 锄 孰
舐	什 实 师 试 世 视 式 使 失 识 示 士 适 湿 饰
怵	出 吃 处 初 除 楚 础 触 储 池 厨 蔬 丶 橱 雏
蜍	数 书 术 属 熟 述 束 树 舒 叔 殊 暑 鼠 署 疏
嘢	也 业 夜 爷 亿 野 页 叶 予 液 耶 椰 冶 噎 烨
碴	持 差 察 茶 插 尺 痴 莎 叉 诈 驰 齿 岔 茬 诧
芃	等 朋 蒙 碰 凤 捧 鹏 冯 孟 彭 棚 泵 蹭 蓬 膨
纾	数 书 术 属 熟 述 束 树 舒 叔 殊 暑 鼠 署 疏
佃	天 团 千 简 田 填 甜 添 舔 帘 掂 碱 敛 癫 黏
葚	人 本 然 文 问 认 任 温 忍 仍 仁 愤 吻 芬 韧
鲢	联 连 练 恋 脸 链 炼 怜 莲 廉 辨 谅 帘 敛 拣
汨	米 密 迷 秘 蜜 眉 弥 咪 谜 幂 泌 靡 觅 眯 糜
珙	工 公 东 从 功 共 供 攻 恐 宫 贡 恭 泳 踪 鸿
缱	前 钱 千 潜 迁 牵 歉 谦 遣 铅 乾 倩 嵌 谴 黔
沵	米 密 迷 秘 蜜 眉 弥 咪 谜 幂 泌 靡 觅 眯 糜
鼹	验 严 颜 炎 艳 燕 盐 岩 掩 宴 咽 衍 腌 堰 焉
顼	需 许 续 须 序 虚 绪 徐 蓄 叙 旭 畜 絮 恤 婿
酐	望 航 忘 杭 昂 狼 丈 芳 脏 荒 洪 肠 虹 恍 琅
侩	开 快 块 怪 乖 慨 淮 拐 楷 窥 恺 筷 盔 魁 匮
豢	欢 款 远 换 环 惯 幻 患 缓 唤 喘 娟 憨 媛 焕
蓿	需 许 续 须 序 虚 绪 徐 蓄 叙 旭 畜 絮 恤 婿
蒹	件 见 简 检 坚 健 监 键 浅 剪 肩 舰 奸 煎 捡
娉	平 听 清 评 宁 厅 令 庆 聘 凭 瓶 苹 旁 萍 叮
颔	航 汉 韩 含 寒 涵 喊 汗 憾 函 俺 撼 旱 晗 焊
牠	他 她 图 妈 它 达 塔 踏 瓦 鸭 叭 爬 塌 祂 惕
煨	微 未 围 卫 威 唯 尾 薇 魏 畏 蔚 巍 惟 潍 纬
畲	设 社 适 势 摄 舍 射 涉 彻 氏 吓 厦 蛇 奢 舌
沣	风 丰 封 灯 峰 疯 凤 锋 奉 崩 缝 蜂 冯 逢 讽
膦	联 连 练 恋 脸 链 炼 怜 莲 廉 辨 谅 帘 敛 拣
蘼	米 密 迷 秘 蜜 眉 弥 咪 谜 幂 泌 靡 觅 眯 糜
圻	七 器 弃 欺 骑 戚 契 漆 琪 崎 祁 麒 迄 杞 亟
悌	体 题 提 替 徒 兔 梯 踢 剔 漓 唧 惕 蹄 涕 剃
茕	请 青 穷 枪 墙 胸 凶 晴 腔 琼 汹 窘 匈 蔷 穹
圌	换 环 穿 川 赚 床 船 串 砖 蠢 禅 喘 醇 揣 栓
嗟	接 结 界 姐 介 街 借 截 揭 捷 戒 皆 劫 羯 桔
撺	原 院 选 环 软 寸 串 旋 贯 悬 眷 渲 猿 惭 窜
猷	友 又 游 由 优 油 右 邮 幼 忧 幽 悠 犹 诱 呦
鎏	六 流 球 究 留 刘 柳 浏 溜 瘤 榴 硫 朽 谬 琉
忤	无 务 物 午 舞 误 屋 污 悟 乌 伍 雾 呜 勿 吾
獐	种 长 张 章 钟 掌 账 涨 障 忠 帐 丈 胀 仗 彰
锷	哦 额 恶 俄 呃 饿 鹅 噩 厄 鄂 遏 讹 扼 胺 峨
潋	联 连 练 恋 脸 链 炼 怜 莲 廉 辨 谅 帘 敛 拣
澹	谈 范 弹 探 坛 坦 摊 贪 叹 碳 滩 炭 烫 谭 扳
闾	利 路 律 率 旅 略 虑 垃 侣 璃 履 吕 芦 滤 驴
佤	务 妈 它 达 马 娃 挖 哇 瓦 鸭 爬 喔 袜 蛙 耙
锉	活 错 获 措 惑 哆 挫 裹 翠 豁 醋 嗦 搓 璀 磋
殚	但 单 导 嘚 担 蛋 淡 丹 旦 胆 诞 侃 丸 耽 氮
磡	看 饭 盘 谈 范 慢 寒 刊 堪 砍 坎 侃 勘 攀 炭
贲	本 班 备 闻 奔 倍 纷 宾 搬 笨 氛 狠 苯 瓣 韧
桅	微 未 围 卫 威 唯 尾 薇 魏 畏 蔚 巍 惟 潍 纬
黟	意 已 义 医 移 忆 仪 伊 谊 疫 毅 椅 溢 怡 祎
涐	哦 额 恶 俄 呃 饿 鹅 噩 厄 鄂 遏 娥 讹 扼 峨
胄	周 州 洲 抽 猪 逐 奏 猴 煮 宙 舟 骤 轴 咒 粥
荻	地 第 低 底 弟 递 帝 滴 迪 抵 敌 堤 笛 旳 缔
咘	不 部 步 补 布 趣 波 顾 捕 屈 怖 卜 埠 凸 醋
琬	完 万 玩 晚 湾 弯 碗 挽 塆 丸 婉 顽 腕 榄 宛
垚	要 约 药 摇 邀 腰 妖 耀 遥 咬 谣 岆 瑶 姚 捣
昴	报 脑 毛 爆 猫 贸 貌 冒 矛 苗 帽 茅 冇 茂 壕
嘌	教 条 票 跳 漂 妙 朴 飘 辽 喵 钓 飙 嫖 婊 缪
羧	所 错 苏 索 锁 缩 洛 措 惑 夺 扫 霍 琐 嫂 琢
轭	哦 额 恶 俄 呃 饿 鹅 噩 厄 鄂 遏 娥 讹 扼 峨
孀	创 伤 双 黄 状 床 赏 皇 庄 妆 爽 撞 壮 荒 谎
刎	文 问 微 温 卫 粉 闻 稳 纷 纹 吻 畏 挽 丸 雯
钒	反 言 饭 范 翻 烦 犯 凡 繁 返 泛 番 沿 杆 帆
滟	验 严 颜 炎 艳 燕 盐 岩 掩 宴 咽 衍 腌 堰 焉
夥	活 或 货 火 获 伙 悔 缩 郭 惑 裸 霍 祸 豁 陀
薹	才 太 台 改 卖 态 淘 盖 探 泰 胎 唉 柏 摊 哉
蝰	会 回 惠 汇 挥 灰 辉 徽 毁 绘 恢 贿 讳 卉 晖
玳	代 海 孩 带 待 材 嘚 贷 莱 戴 呆 袋 歪 歹 黛
姹	持 查 差 察 茶 插 尺 痴 莎 叉 诈 驰 齿 岔 茬
蓁	镇 针 珍 圳 震 阵 诊 侦 贞 甄 枕 帧 疹 臻 朕
尻	考 早 造 靠 淘 烤 骚 阔 躁 澡 砍 坎 岆 瑶 拷
倏	书 术 属 熟 述 树 舒 叔 殊 暑 鼠 署 疏 蔬 梳
殄	天 千 简 田 填 甜 添 舔 帘 掂 碱 敛 毯 癫 黏
鏖	博 早 案 造 奥 澳 傲 熬 凹 瑶 敖 嗷 袄 艹 蘑
恸	同 通 统 痛 童 综 铜 筒 桶 躺 桐 彤 瞳 耸 珑
莜	友 又 游 由 优 油 右 邮 幼 忧 幽 悠 犹 诱 呦
俎	组 足 族 租 虚 陆 巨 库 偶 祖 阻 狐 卒 诅 戮
囍	西 喜 习 吸 媳 晰 稀 溪 夕 兮 茜 犀 烯 熄 嬉
裟	失 识 啥 杀 沙 傻 厦 晒 蛇 纱 莎 屎 扇 叉 疏
稔	人 本 认 门 任 忍 仁 纹 吻 苯 嫩 韧 壬 刃 恳
缢	意 已 义 医 移 忆 仪 伊 谊 疫 毅 椅 溢 怡 祎
荪	论 婚 诉 速 岁 散 损 孙 滚 循 蕴 蒜 笋 钝 隧
澍	书 术 属 熟 述 树 舒 叔 殊 暑 署 疏 蔬 梳 抒
褴	担 络 兰 蓝 览 烂 懒 篮 栏 滥 谭 衍 攒 拦 澜
驷	四 司 思 死 斯 食 激 似 丝 私 撕 寺 肆 饲 畸
滂	放 访 央 棒 旁 绑 仰 旸 棚 庞 痒 沧 磅 乒 肪
儆	经 京 境 景 警 惊 竞 镜 净 敬 睛 径 晶 井 颈
徳	多 或 托 毒 缩 郭 洛 夺 朵 哆 躲 堕 捣 怼 剁
佷	很 任 喝 甚 恨 涵 喷 喊 吓 哼 闷 笨 汗 狠 痕
缳	欢 款 远 换 环 惯 幻 患 缓 唤 喘 娟 悍 憨 媛
祚	作 做 错 座 左 坐 租 索 昨 措 桌 遭 惑 夺 阻
鬣	节 列 铁 烈 裂 猎 劣 咧 膊 喱 亵 砺 凛 拮 冽
稹	真 镇 针 珍 圳 震 阵 诊 侦 贞 甄 枕 帧 疹 臻
啶	定 清 顶 订 迎 档 硬 丁 径 冻 鼎 钉 盯 冥 叮
峒	同 通 统 痛 童 铜 筒 桶 轰 桐 彤 瞳 耸 珑 捅
蚜	亚 呀 压 雅 牙 押 涯 鸭 丫 吖 芽 榆 讶 哑 鸦
涔	前 钱 千 签 潜 迁 欠 牵 歉 谦 遣 铅 乾 倩 嵌
覅	表 变 校 标 暴 脚 秒 飘 浇 飙 彪 婊 刁 僚 叼
膻	产 山 善 删 闪 憾 扇 陕 擅 衫 珊 杉 汕 姗 煽
袈	家 加 价 假 酒 佳 架 驾 甲 嘉 嫁 夹 贾 迦 钾
篑	快 鬼 嘴 哭 亏 阔 馈 愧 溃 摧 葵 窥 盔 魁 奎
菖	产 场 常 充 唱 伤 承 厂 偿 昌 尝 畅 肠 倡 阐
湫	就 九 究 酒 久 救 旧 纠 仇 舅 揪 玖 韭 灸 钮
舷	现 险 显 县 献 闲 陷 嫌 贤 羡 纤 弦 宪 咸 掀
谶	称 陈 审 甚 沉 晨 扯 阵 尘 诊 辰 臣 趁 衬 秤
铨	全 款 权 远 段 券 泉 劝 拳 犬 冤 乾 倦 倩 嵌
噫	意 已 义 医 移 忆 仪 伊 谊 疫 毅 椅 溢 怡 祎
簌	读 诉 速 曲 护 岁 父 食 素 苏 宿 姑 谷 绪 俗
栉	之 知 只 直 质 值 智 纸 址 枝 脂 吱 秩 稚 挚
銮	乱 伦 券 幻 缘 圆 卷 链 患 缓 炼 览 烂 悬 锻
瘢	办 班 版 半 般 板 巴 伴 搬 颁 斑 扮 瓣 炭 鞭
谘	自 子 资 字 咨 仔 紫 姿 滋 兹 籽 淄 梓 疵 呲
褛	利 路 律 率 旅 略 虑 垃 侣 璃 履 吕 芦 滤 驴
疥	接 结 界 姐 介 街 借 截 揭 捷 戒 皆 劫 羯 桔
昶	产 场 常 充 唱 伤 承 厂 偿 昌 尝 畅 肠 倡 阐
浃	家 加 价 假 酒 佳 架 驾 甲 嘉 嫁 夹 贾 迦 钾
窠	可 科 客 课 克 刻 颗 渴 壳 柯 涩 磕 棵 苛 坷
谡	读 诉 速 曲 护 岁 父 食 素 苏 宿 姑 谷 绪 俗
曺	约 脑 财 操 草 曹 挫 躁 澡 岆 瑶 捞 姚 糙 嘈
嶙	引 李 林 临 邻 厘 劣 琳 淋 赁 敛 锌 沥 麟 霖
麂	己 计 级 及 技 集 即 急 激 纪 继 吉 辑 挤 忌
瑁	没 美 费 每 妹 媒 梅 煤 魅 眉 玫 霉 枚 昧 媚
妣	比 必 毕 笔 币 逼 避 闭 鼻 壁 弊 蔽 屄 毙 庇
鲛	教 交 校 较 叫 角 脚 焦 胶 娇 骄 郊 矫 搅 蕉
黒	每 海 北 何 配 黑 威 杯 肥 泪 嘿 痕 薇 魏 肺
禛	真 镇 针 珍 圳 震 阵 诊 振 侦 贞 甄 枕 帧 疹
茌	吃 持 迟 池 尺 赤 痴 驰 齿 耻 斥 侈 翅 炽 嗤
峋	论 训 询 寻 讯 迅 循 巡 逊 旬 勋 熏 驯 薰 歆
秭	自 子 资 字 咨 仔 紫 姿 滋 兹 籽 淄 梓 疵 呲
讫	起 七 器 弃 欺 骑 戚 契 漆 琪 崎 祁 麒 迄 杞
嬗	产 山 善 删 闪 憾 扇 陕 擅 衫 珊 杉 汕 姗 煽
刈	意 已 义 医 移 忆 仪 伊 谊 疫 毅 椅 溢 怡 祎
衾	音 汽 琴 倾 勤 侵 秦 寝 斌 钦 禽 尹 怯 沁 芹
茭	教 交 校 较 叫 角 脚 焦 胶 娇 骄 郊 矫 搅 蕉
霰	现 险 显 县 献 闲 陷 嫌 贤 羡 纤 弦 宪 咸 掀
唳	理 里 力 利 励 厉 厘 璃 哩 荔 吏 篱 鲤 俐 俪
矬	活 错 获 措 惑 夺 哆 挫 裹 翠 豁 醋 嗦 搓 璀
挲	所 错 索 锁 缩 拖 扩 洛 措 惑 夺 霍 肃 躲 琐
偈	起 七 器 弃 欺 骑 戚 契 漆 琪 崎 祁 麒 迄 杞
霭	爱 哎 艾 唉 碍 埃 欸 挨 哀 晰 癌 矮 暧 吏 隘
啲	地 第 低 底 弟 递 帝 滴 迪 抵 敌 蒂 堤 笛 旳
敕	吃 持 迟 池 尺 赤 痴 驰 齿 耻 斥 侈 翅 炽 嗤
嘭	等 朋 凭 蒙 碰 凤 捧 鹏 冯 孟 彭 棚 泵 蹭 蓬
桁	程 省 征 碰 衡 凤 恒 横 哼 冯 蒸 扔 昇 翁 睁
伉	航 控 防 党 忙 康 浪 港 忘 杨 洋 抗 扛 镑 乓
怏	样 养 阳 杨 央 洋 扬 羊 仰 盐 郎 氧 旸 痒 烊
痍	意 已 义 医 移 忆 仪 伊 谊 疫 毅 椅 溢 怡 祎
倌	关 管 观 官 馆 惯 冠 钻 贯 灌 莞 罐 棺 纶 竿
枳	之 知 只 直 质 值 智 纸 址 枝 脂 吱 秩 稚 挚
阄	就 九 究 酒 久 救 旧 纠 仇 舅 揪 玖 韭 灸 钮
龛	看 饭 盘 谈 范 慢 寒 刊 堪 砍 坎 侃 勘 攀 炭
凇	红 共 送 供 控 松 聪 宋 讼 轰 诵 颂 雍 嵩 怂
惇	困 顿 督 盾 敦 逊 裙 吨 蹲 芸 镀 囤 舵 笋 钧
箜	总 空 控 痛 童 拥 松 弄 恐 孔 隆 浓 贡 洪 笼
峯	风 丰 封 灯 峰 疯 凤 锋 奉 崩 缝 蜂 冯 逢 讽
蒡	帮 半 伴 榜 兵 棒 羊 唐 邦 绑 狼 膀 烫 嗓 壤
舫	方 放 房 反 防 访 央 棒 仿 芳 坊 妨 躺 纺 贩
铄	数 水 货 税 睡 索 束 树 著 硕 殊 稍 祸 捉 薯
鞣	友 候 入 楼 油 购 欧 肉 悠 柔 凑 猴 兜 酉 喉
呶	付 足 句 努 屋 欲 促 距 幅 督 肤 怒 拘 喻 呐
岘	现 限 险 显 县 鲜 陷 嫌 贤 羡 咁 纤 弦 宪 咸
樾	月 员 越 阅 液 悦 跃 岳 玥 薛 裕 爵 粤 曰 榆
溏	庭 堂 唐 糖 汤 仿 躺 塘 趟 烫 缸 棠 倘 螃 滕
堀	付 足 句 苦 库 哭 酷 宿 咯 屋 欲 促 裤 狱 腹
鳜	觉 结 决 绝 阅 皆 掘 爵 诀 崛 抉 倔 厥 榷 獗
鸬	路 绿 鲁 鹿 卢 碌 撸 芦 璐 卤 禄 噜 泸 虏 麓
飨	想 相 像 强 向 象 项 响 香 享 乡 箱 详 仙 翔
蹑	节 写 界 逆 蝶 匿 捏 疟 咩 孽 迭 妾 诫 聂 涅
咗	作 做 错 座 左 坐 租 索 昨 措 桌 遭 惑 夺 阻
陉	行 性 并 星 形 型 兴 幸 醒 映 欣 姓 刑 盈 馨
尐	接 结 节 界 姐 介 街 借 截 揭 捷 戒 皆 劫 羯
孓	觉 结 决 绝 阅 皆 掘 爵 诀 崛 抉 倔 厥 榷 獗
泔	感 干 版 敢 赶 探 刊 甘 杆 肝 尴 杠 丸 赣 竿
鄄	管 件 款 端 圈 卷 泉 浅 捐 玄 劵 倦 娟 媛 眷
绦	早 造 套 讨 淘 邀 逃 稿 桃 陶 涛 稻 捣 萄 掏
簋	规 贵 归 鬼 柜 瓜 轨 跪 瑰 桂 闺 龟 硅 棍 诡
渑	金 名 民 满 印 敏 蜜 芯 咪 寝 斌 闽 旻 闵 悯
谒	也 业 夜 爷 野 页 叶 予 欲 液 耶 椰 冶 噎 烨
箐	情 名 请 清 亲 评 青 轻 静 庆 聘 抢 凭 倾 铃
睥	被 批 皮 屁 脾 疲 匹 啤 劈 癖 坯 霹 琵 毗 媲
訾	自 子 资 字 咨 仔 紫 姿 滋 兹 籽 淄 梓 疵 呲
僳	诉 速 曲 护 岁 父 素 苏 宿 谷 绪 俗 塑 肃 牧
煊	选 宣 旋 悬 暅 炫 玄 轩 萱 喧 渲 绚 璇 嬛 眩
趵	跑 奥 泡 胖 邀 逃 遭 稿 扰 炮 抛 啪 膏 苞 袍
锃	等 正 朋 增 曾 登 仍 疯 碰 赠 捧 鹏 棚 睁 筝
忾	开 待 卖 态 载 牌 财 排 拍 害 嘅 凯 溃 慨 狸
衿	音 汽 琴 勤 侵 秦 谨 寝 钦 禽 尹 怯 沁 芹 麒
愎	比 必 毕 笔 币 逼 避 闭 鼻 弊 蔽 屄 毙 庇 哔
癀	黄 床 皇 荒 凰 谎 慌 煌 晃 恍 桓 疮 幢 惶 簧
鹚	次 此 词 急 笔 依 击 材 刺 辞 圾 磁 慈 瓷 赐
喙	回 汇 挥 灰 悔 辉 徽 毁 绘 恢 贿 讳 卉 晖 晦
卍	完 万 玩 晚 湾 弯 碗 挽 塆 丸 婉 顽 腕 榄 宛
菟	图 布 足 句 土 突 途 宿 屋 欲 促 吐 徒 兔 涂
溆	需 许 续 须 苏 序 雪 附 虚 绪 徐 蓄 叙 旭 畜
蒯	开 快 块 怪 宽 乖 溃 慨 恺 筷 盔 魁 槐 胯 傀
囗	微 未 围 卫 威 唯 尾 薇 魏 韦 畏 蔚 巍 惟 潍
尛	模 默 魔 末 摩 莫 磨 摸 膜 墨 陌 脉 寞 抹 漠
嵬	微 未 围 卫 威 唯 尾 薇 魏 韦 畏 蔚 巍 惟 潍
涠	微 未 围 卫 威 唯 尾 薇 魏 韦 畏 蔚 巍 惟 潍
魑	吃 持 至 迟 池 尺 赤 痴 驰 齿 耻 斥 侈 翅 炽
臬	节 写 界 逆 蝶 匿 捏 疟 咩 孽 迭 妾 诫 聂 涅
垡	发 法 亚 怕 饭 附 罚 乏 伏 覆 伐 砸 祂 阀 哑
辎	自 子 资 字 咨 仔 紫 姿 滋 兹 籽 淄 梓 疵 呲
垵	安 案 阿 按 翻 暗 寒 岸 燕 俺 氨 鞍 妍 敖 惋
彡	产 山 善 删 闪 扇 陕 擅 衫 珊 杉 掺 汕 姗 煽
郏	家 加 价 假 酒 佳 架 驾 甲 嘉 嫁 夹 贾 迦 钾
疖	接 结 节 界 姐 介 街 借 截 揭 捷 戒 皆 劫 羯
骈	件 片 便 限 连 篇 荐 键 骗 偏 浅 牵 潘 叛 扁
湟	光 广 况 狂 宽 矿 框 谎 慌 煌 扛 旷 匡 簧 慷
糸	斯 米 密 迷 秘 替 蜜 弥 咪 谜 幂 泌 靡 觅 眯
耆	起 七 器 弃 欺 骑 戚 契 漆 琪 崎 祁 麒 迄 杞
醪	老 造 络 跑 劳 腰 桃 陶 牢 捞 姥 佬 拦 唠 袍
葺	起 七 器 弃 欺 骑 戚 契 漆 琪 崎 祁 麒 迄 杞
铊	讨 索 托 脱 锁 拖 拓 桃 陶 妥 魄 陀 驼 唾 糯
葳	微 未 围 卫 威 唯 尾 薇 魏 韦 畏 蔚 巍 惟 潍
俳	白 台 改 牌 排 拍 嘚 派 盖 哎 迫 埃 欸 挨 佩
翦	件 见 简 检 坚 监 键 浅 剪 肩 舰 奸 煎 捡 牋
崆	通 统 空 控 融 康 勇 恐 宏 孔 桐 垄 彤 瞳 粽
镉	个 格 歌 各 热 哥 革 隔 割 戈 葛 柯 叻 鸽 阁
埭	代 海 带 待 材 嘚 贷 莱 戴 麦 呆 袋 歪 歹 黛
蝮	福 父 负 富 府 夫 附 浮 扶 伏 覆 芙 辐 阜 孵
谪	这 着 者 折 喆 哲 浙 遮 柱 汁 煮 殖 辙 褶 辄
哝	总 统 空 农 弄 冬 宗 洞 聪 董 宏 宋 浓 烘 瞳
跖	之 知 只 直 质 值 智 纸 址 枝 脂 汁 吱 秩 稚
畿	己 机 几 系 计 记 基 际 季 鸡 圾 忌 稽 祭 棘
蜱	被 批 皮 屁 脾 疲 匹 啤 劈 癖 坯 霹 琵 毗 媲
祗	之 知 只 直 质 值 智 纸 址 枝 脂 汁 吱 秩 稚
殒	员 运 云 孕 允 寸 燕 晕 韵 蕴 匀 芸 酝 耘 陨
瘊	后 候 游 户 构 肉 尤 厚 忽 犹 猴 侯 吼 喉 咒
篌	后 候 游 户 构 肉 尤 厚 忽 犹 猴 侯 吼 喉 咒
鳃	海 孩 试 世 思 害 势 赛 灾 塞 拾 挨 哀 歪 苔
擤	行 性 并 星 形 型 兴 幸 醒 映 欣 姓 刑 盈 馨
赟	员 运 云 孕 允 寸 燕 晕 韵 蕴 匀 芸 酝 耘 陨
髌	音 近 边 遍 避 欣 宾 滨 饼 辨 谨 斌 彬 尹 昕
噤	进 金 今 近 极 尽 仅 紧 津 禁 劲 斤 锦 谨 晋
畈	反 言 饭 范 翻 烦 犯 凡 繁 返 泛 番 沿 函 杆
瓒	万 反 南 玩 担 赞 咱 暂 繁 蛮 帆 鞍 崽 碳 勘
眦	自 子 资 字 咨 仔 紫 姿 滋 兹 籽 淄 梓 疵 呲
貉	和 合 何 呵 河 核 喝 射 盒 泽 荷 吓 赫 贺 禾
茼	同 通 统 痛 童 综 铜 筒 桶 讼 桐 彤 瞳 聋 捅
橹	路 录 绿 鲁 鹿 炉 卢 碌 撸 芦 卤 禄 噜 泸 虏
僭	件 见 简 检 坚 监 键 浅 剪 肩 舰 奸 煎 捡 牋
謇	件 见 简 检 坚 监 键 浅 剪 肩 舰 奸 煎 捡 牋
爨	原 院 选 环 软 寸 串 旋 贯 悬 眷 渲 猿 惭 窜
荸	比 必 毕 笔 币 逼 避 鼻 弊 蔽 屄 毙 庇 哔 陛
颢	好 号 导 豪 毫 薄 澳 耗 浩 绕 胞 昭 嚎 昊 壕
谯	巧 桥 乔 歉 敲 喵 悄 瞧 雀 嵌 侨 翘 俏 掐 硝
岙	早 案 造 奥 澳 傲 熬 凹 漠 瑶 敖 嗷 袄 菠 艹
舸	个 格 歌 各 热 哥 革 隔 割 戈 葛 柯 叻 鸽 阁
掼	关 管 观 官 馆 惯 冠 钻 贯 灌 莞 罐 棺 纶 竿
龇	自 子 资 字 咨 仔 紫 姿 滋 兹 籽 淄 梓 疵 呲
酊	定 东 命 轻 兴 顶 订 兵 迎 硬 丁 鼎 钉 盯 叮
笤	交 校 调 条 疗 跳 挑 逃 苗 浇 僚 逍 叼 滔 枭
钕	女 嗯 努 虑 尼 拟 娜 怒 虐 伱 倪 滤 驴 溺 钠
虬	求 且 企 球 秋 仇 丘 玖 岂 韭 邱 囚 糗 岐 矜
酩	明 名 星 精 命 蒙 瓶 敏 鸣 铭 樱 颈 廷 霆 冥
囹	零 领 另 灵 令 龄 晶 凌 玲 铃 陵 岭 菱 聆 伶
仝	同 通 统 痛 童 综 铜 筒 桶 讼 躺 婷 桐 彤 瞳
苎	主 住 助 祝 筑 猪 逐 珠 诸 竹 驻 柱 煮 丶 烛
擘	博 毕 播 波 伯 拨 墨 玻 寞 勃 搏 泊 驳 脖 渤
黜	出 吃 处 初 除 楚 础 触 储 池 厨 蔬 丶 橱 雏
馃	国 过 果 挂 弱 锅 郭 稿 夺 裹 癸 唾 锣 蝈 椁
弢	早 造 套 讨 淘 邀 逃 稿 桃 陶 涛 稻 捣 萄 掏
囯	国 过 果 挂 弱 锅 郭 稿 夺 裹 癸 唾 锣 蝈 椁
鲱	费 非 飞 危 肥 菲 废 啡 胃 肺 妃 匪 沸 绯 镁
鲇	年 念 篇 典 监 脸 减 荐 键 骗 仙 黏 碾 蔫 撵
馕	放 男 房 杨 访 央 棒 钢 仰 囊 旸 痒 沧 壤 棠
蛏	成 程 城 承 陈 诚 盛 乘 尝 症 虫 撑 呈 辰 趁
嗄	失 识 啥 杀 沙 傻 厦 晒 蛇 纱 莎 屎 扇 叉 疏
圄	于 预 遇 域 余 雨 宇 愉 郁 愚 寓 逾 瑜 舆 俞
钡	费 北 备 背 卫 悲 贝 雷 违 辈 杯 倍 呗 碑 卑
頫	福 父 负 富 府 夫 附 妇 浮 扶 伏 覆 芙 辐 阜
濯	抓 著 桌 卓 捉 兆 拙 缀 灼 浊 绰 酌 镯 诏 侏
劭	少 号 找 杀 绍 烧 稍 闪 召 吵 耗 扇 嫂 衫 邵
痦	无 务 物 午 舞 误 吴 屋 污 乌 伍 呜 勿 吾 巫
诤	重 正 证 政 整 争 涨 征 震 郑 症 忠 挣 肿 蒸
犇	本 任 班 备 闻 奔 倍 纷 宾 搬 笨 狠 苯 瓣 韧
绌	抓 著 桌 卓 捉 兆 拙 缀 灼 浊 绰 酌 镯 诏 侏
绶	手 数 收 书 受 首 售 守 舒 授 丑 筹 寿 兽 暑
椹	真 镇 针 珍 圳 震 阵 诊 振 侦 贞 枕 帧 疹 臻
埚	国 过 果 左 鬼 锅 姑 郭 洛 措 裹 咕 嗦 呱 灬
鬃	重 总 供 综 勇 攻 恐 宗 纵 踪 笼 佣 丛 彤 雍
瀣	些 解 谢 写 协 鞋 械 邪 谐 蟹 携 泄 蝎 歇 卸
掴	国 过 果 左 锅 郭 洛 拓 裹 咕 嗦 呱 灬 咄 羔
闳	东 功 红 终 综 荣 宏 洪 纵 虹 鸿 轰 笼 佣 哄
戕	相 强 亲 香 庆 乡 抢 梁 枪 墙 谅 腔 遣 铅 呛
沢	字 客 课 哥 则 责 紫 液 泽 磕 冶 棵 褐 啧 孜
沆	望 航 忘 杭 昂 狼 丈 芳 脏 荒 洪 虹 恍 琅 乓
锝	的 得 特 格 科 德 底 哥 答 弟 喝 野 嚒 页 递
傈	理 里 力 利 励 厉 厘 璃 哩 荔 吏 篱 鲤 俐 俪
堃	论 询 困 跨 孕 君 刊 盾 昆 阔 坤 蕴 啃 捆 郡
苕	少 号 找 杀 绍 烧 稍 闪 召 吵 耗 扇 嫂 衫 邵
坩	感 干 饭 敢 赶 甘 函 杆 肝 尴 蔓 腕 氮 赣 竿
喺	西 喜 习 吸 媳 晰 稀 溪 夕 兮 茜 犀 烯 熄 嬉
苁	从 童 松 藏 综 聪 贡 洪 虹 恭 葱 匆 丛 沧 耸
瓤	让 浪 朗 仓 亡 糖 旁 坊 茫 汪 苍 丧 葬 廊 壤
翳	意 已 义 医 移 依 忆 仪 伊 谊 疫 毅 椅 溢 怡
挈	且 切 协 贴 揭 械 叠 窃 斜 捏 伽 茄 妾 怯 惬
愠	员 运 云 孕 允 晕 韵 裙 蕴 匀 芸 酝 耘 陨 昀
銆	模 默 魔 末 摩 莫 磨 摸 膜 墨 陌 脉 寞 抹 漠
淦	感 干 饭 敢 赶 甘 函 杆 肝 尴 蔓 腕 氮 赣 竿
硌	理 里 力 利 励 厉 厘 璃 哩 荔 吏 篱 鲤 俐 俪
姘	品 片 音 尽 频 临 拼 贫 淋 潘 匹 鑫 叛 钦 沁
遒	求 且 球 秋 仇 丘 玖 岂 韭 邱 囚 糗 岐 矜 沏
鲳	产 场 常 充 唱 伤 承 厂 偿 昌 尝 畅 肠 倡 闯
靛	点 电 店 连 典 蛋 垫 歉 莲 吊 锻 羡 颠 淀 殿
铱	意 已 义 医 移 忆 仪 伊 谊 疫 毅 椅 溢 怡 祎
锗	这 着 者 折 喆 哲 浙 遮 柱 汁 煮 殖 辙 褶 辄
吥	不 部 步 补 布 趣 波 捕 屈 怖 卜 埠 凸 醋 簿
虻	明 梦 增 盟 蒙 萌 赠 猛 捧 孟 庚 懵 愣 亨 檬
煅	观 店 款 段 断 短 端 泉 诞 援 旋 贯 劝 垫 拳
矽	西 喜 习 吸 媳 晰 稀 溪 夕 兮 茜 犀 烯 熄 嬉
孳	自 子 字 咨 仔 紫 姿 兹 孜 籽 淄 梓 疵 呲 渍
啻	吃 持 至 迟 池 尺 赤 痴 驰 齿 耻 斥 侈 翅 炽
诂	股 古 顾 估 鼓 固 骨 孤 姑 谷 雇 辜 菇 咕 沽
螈	原 院 元 远 源 愿 园 缘 圆 怨 援 袁 苑 冤 渊
痼	股 古 顾 估 鼓 固 骨 孤 姑 谷 雇 辜 菇 咕 沽
邨	员 存 村 询 讯 轮 尊 损 俊 寸 挫 菌 韵 粹 蚕
铳	成 常 城 充 众 冲 乘 尝 聪 崇 虫 宏 畅 宠 肠
邗	航 汉 韩 含 寒 涵 喊 汗 憾 函 撼 旱 晗 焊 翰
捭	百 白 台 改 嘅 奶 抱 贝 拜 败 摆 拔 塞 迫 柏
龘	大 打 单 度 达 答 呀 搭 罚 娜 涯 哒 稻 嗒 睹
揾	文 问 微 温 卫 粉 闻 稳 纷 纹 伪 吻 畏 挽 雯
傩	或 座 获 托 诺 缩 阔 萝 挪 搓 惰 懦 唾 锣 糯
嗮	海 孩 试 世 思 害 势 赛 灾 塞 拾 挨 哀 歪 苔
鹬	于 预 遇 域 余 雨 宇 愉 郁 愚 寓 逾 瑜 舆 俞
粲	参 饭 村 谈 范 慢 餐 残 惨 灿 滥 婉 谭 衍 旱
嘧	极 米 密 迷 秘 蜜 眉 弥 咪 谜 幂 泌 靡 觅 眯
杈	持 查 差 察 茶 插 尺 厨 痴 莎 叉 诈 驰 齿 岔
阕	越 确 且 却 切 趣 缺 屈 裙 诀 崛 茄 靴 妾 怯
佞	平 影 青 病 宁 娘 硬 竞 龄 晶 井 凝 莹 聆 憬
蹇	钱 千 签 迁 欠 牵 歉 谦 遣 铅 乾 倩 嵌 谴 黔
喰	参 饭 村 谈 范 慢 餐 残 惨 灿 滥 婉 谭 衍 旱
瘆	身 神 深 称 申 审 甚 舍 沈 尘 瞬 伸 慎 肾 渗
蟥	欢 黄 床 皇 壮 荒 凰 唤 谎 慌 煌 晃 恍 疮 幢
猗	意 已 义 医 移 忆 仪 伊 谊 疫 毅 椅 溢 怡 祎
檄	西 喜 习 吸 媳 晰 稀 溪 夕 兮 茜 犀 烯 熄 嬉
郢	应 影 英 迎 硬 映 赢 盈 颖 婴 鹰 樱 莹 荧 萤
铡	制 找 查 志 债 珠 哲 咋 扎 炸 渣 诈 罩 闸 榨
枥	理 里 力 利 历 励 厉 厘 璃 哩 荔 吏 篱 鲤 俐
菓	国 过 果 左 鬼 锅 姑 郭 洛 拓 裹 咕 嗦 磋 蝈
塬	原 院 元 远 源 愿 园 缘 圆 怨 援 袁 苑 冤 渊
槎	持 查 差 察 茶 插 尺 厨 痴 莎 叉 诈 驰 齿 岔
囝	男 难 南 干 演 满 版 晚 弹 暖 湾 沿 函 杆 堪
笞	吃 持 至 迟 池 尺 赤 痴 驰 齿 耻 斥 侈 翅 炽
哋	切 递 杰 跌 丢 爹 蟹 蝶 碟 叠 斜 捏 堤 桔 鳎
琮	从 童 藏 综 聪 贡 洪 踪 葱 匆 丛 哄 沧 烘 憧
逯	路 录 陆 绿 鲁 鹿 炉 卢 撸 芦 璐 卤 庐 禄 噜
缛	如 入 布 母 故 诉 付 吴 虎 予 乳 腹 辱 儒 嘟
柞	作 做 错 座 左 坐 租 索 昨 洛 措 桌 遭 惑 夺
疽	车 局 句 居 举 距 拒 俱 惧 矩 菊 焗 橘 狙 鞠
忪	送 龙 永 松 宋 纵 虹 桑 涌 讼 诵 颂 桐 巩 嵩
祜	户 护 互 乎 湖 呼 胡 虎 忽 糊 狐 沪 壶 蝴 葫
嶂	长 重 场 常 张 章 掌 账 涨 障 妆 帐 丈 胀 仗
犍	间 见 检 坚 键 剑 兼 践 鉴 尖 浅 剪 艰 肩 奸
囼	才 太 代 台 改 态 淘 盖 探 泰 胎 唉 摊 宰 哉
媾	够 购 构 狗 骨 沟 勾 喽 酉 喉 钩 剖 苟 眸 疣
鼋	原 院 元 远 愿 园 缘 圆 怨 援 袁 苑 冤 渊 媛
鎴	西 喜 习 吸 媳 晰 稀 溪 夕 兮 茜 犀 烯 熄 嬉
磬	情 请 清 亲 青 轻 庆 硬 倾 晴 卿 擎 氢 拎 穹
巿	福 父 负 富 府 夫 附 妇 浮 扶 伏 覆 芙 辐 阜
蘅	程 声 省 诚 征 衡 凤 恒 横 哼 冯 蒸 扔 昇 逢
讣	福 父 负 富 府 夫 附 妇 浮 扶 伏 覆 芙 辐 阜
俟	七 器 弃 欺 骑 戚 契 漆 琪 崎 祁 麒 迄 杞 亟
爰	原 院 元 远 愿 园 缘 圆 怨 援 袁 苑 冤 渊 媛
锱	自 子 资 字 咨 仔 紫 姿 滋 兹 孜 籽 淄 疵 呲
姒	四 司 思 死 斯 食 依 礼 激 似 丝 私 撕 寺 肆
鐧	件 见 简 检 坚 监 浅 剪 肩 舰 奸 煎 捡 牋 槛
阏	验 严 烟 颜 炎 艳 燕 盐 岩 掩 宴 咽 衍 腌 堰
虢	国 过 果 左 伙 鬼 锅 郭 柜 洛 拓 跪 裹 卦 咕
喟	快 嘴 哭 挥 亏 轨 馈 愧 溃 葵 窥 盔 魁 奎 匮
噙	您 千 器 青 琴 勤 侵 秦 邻 仇 寝 氢 锌 钦 禽
亓	七 器 弃 欺 骑 戚 契 漆 琪 崎 祁 麒 迄 杞 亟
鍦	师 身 设 社 属 核 摄 舍 射 涉 蛇 遮 奢 舌 赎
崧	送 龙 永 松 宋 纵 虹 桑 讼 诵 颂 桐 垄 巩 嵩
埙	选 宣 旋 悬 暅 炫 玄 轩 萱 喧 渲 绚 璇 嬛 眩
氵	说 师 数 水 税 睡 诗 述 输 释 灰 悔 吹 尸 殊
钺	月 觉 与 越 缺 阅 娱 孕 悦 跃 岳 御 掘 玥 渔
佶	己 机 几 系 计 记 基 际 季 鸡 圾 忌 稽 祭 棘
岿	快 嘴 哭 挥 亏 馈 愧 溃 葵 窥 盔 魁 奎 匮 傀
啉	络 兰 蓝 览 烂 懒 篮 栏 滥 婉 谭 衍 攒 拦 翰
圪	个 格 歌 各 热 根 哥 革 隔 割 戈 葛 柯 鸽 阁
觥	工 公 功 共 供 攻 宫 隆 浓 贡 恭 弘 溶 桐 巩
鲠	更 刚 登 港 疼 蒙 疯 缝 蜂 耕 梗 庚 巩 枫 翁
锟	论 运 询 困 孕 君 盾 昆 阔 坤 蕴 啃 捆 郡 阚
齉	放 男 房 杨 访 央 棒 洋 钢 仰 囊 旸 痒 沧 壤
榫	军 询 索 损 孙 碎 俊 晕 沦 蹲 仑 笋 酥 炖 郡
倨	车 剧 局 句 举 距 拒 俱 惧 矩 菊 焗 橘 狙 鞠
骧	想 相 像 向 象 项 响 香 享 乡 箱 详 翔 祥 湘
鹳	关 管 观 官 馆 惯 冠 钻 援 贯 灌 莞 罐 棺 纶
疃	原 院 选 元 团 软 摊 援 旋 贯 拳 眷 臀 渲 猿
牯	股 故 古 顾 估 鼓 固 骨 孤 姑 谷 雇 辜 菇 咕
锴	开 待 卖 态 载 牌 财 排 拍 害 嘅 凯 溃 慨 狸
癔	意 已 义 医 移 忆 仪 伊 谊 疫 毅 椅 溢 怡 颐
雒	落 罗 洛 朵 逻 裸 啰 萝 螺 囖 骆 锣 漯 骡 捋
浘	微 未 围 卫 威 唯 尾 薇 魏 韦 畏 蔚 巍 惟 纬
钿	天 团 限 千 简 田 填 甜 添 舔 帘 掂 碱 敛 癫
泮	干 研 便 满 盘 判 探 蓝 胖 埋 俺 盼 潘 叛 攀
獾	欢 款 远 换 环 惯 幻 患 缓 唤 喘 娟 憨 媛 焕
蝾	容 融 痛 童 拥 松 荣 笼 佣 匆 栋 蓉 绒 溶 桐
铖	成 程 城 承 陈 诚 盛 乘 症 虫 撑 呈 辰 趁 秤
擢	货 祝 抓 著 桌 卓 捉 兆 拙 烁 灼 浊 绰 酌 镯
骶	地 第 低 底 弟 递 帝 滴 迪 抵 敌 蒂 堤 笛 旳
曽	怎 增 曾 腾 萌 坑 哼 赠 孟 枫 翁 蓬 僧 愣 亨
頔	地 第 低 底 弟 递 帝 滴 迪 抵 敌 蒂 堤 笛 旳
玹	选 宣 旋 悬 暅 炫 玄 轩 萱 喧 渲 绚 璇 嬛 眩
瑗	原 院 元 远 源 愿 园 缘 圆 怨 援 袁 苑 冤 渊
嗪	器 青 林 群 琴 勤 侵 秦 仇 丘 寝 乞 钦 禽 沁
锑	体 题 提 依 替 徒 兔 梯 踢 剔 畸 惕 蹄 涕 剃
苻	普 宿 铺 吐 辅 污 谱 驱 扑 浦 葡 菩 埔 仆 蒲
廋	由 楼 优 首 投 搜 鼠 兜 署 肃 抖 疏 嗽 艘 鱿
妁	水 或 税 睡 索 绍 树 舒 著 硕 殊 捉 豁 薯 朔
痈	用 营 永 拥 勇 赢 洞 铜 庸 泳 涌 佣 咏 雍 棕
腈	经 精 京 境 景 警 惊 竞 镜 净 敬 睛 径 晶 井
齺	走 由 周 楼 优 住 投 油 奏 竹 诱 猴 兜 驻 抖
烔	同 通 总 统 痛 童 腾 铜 筒 桶 躺 桐 彤 瞳 珑
锒	两 放 浪 钢 朗 昂 隆 粮 狼 郎 靓 趟 痒 沧 妄
嵯	活 错 获 措 惑 夺 哆 挫 裹 翠 豁 醋 嗦 搓 璀
诳	光 广 况 狂 宽 矿 框 谎 慌 煌 扛 旷 匡 簧 慷
檫	把 它 达 马 阿 斯 素 宿 咯 玛 踏 撒 萨 洒 葩
髯	然 板 饭 盘 染 燃 攀 刃 贩 炭 滥 婉 谭 焊 拌
咭	己 机 几 系 计 记 基 际 季 鸡 圾 忌 稽 祭 棘
嫚	满 谈 慢 漫 贸 蛮 曼 番 埋 迈 滥 婉 谭 衍 瞒
诰	高 告 搞 貌 毫 泡 澳 冒 郭 傲 甘 稿 糕 膏 镐
玏	了 乐 陆 野 雷 页 绿 厉 隔 鲁 肋 叻 偻 醴 鲈
遽	车 具 局 举 巨 聚 距 拒 俱 惧 矩 菊 橘 狙 驹
恹	验 严 烟 颜 炎 艳 燕 盐 沿 岩 掩 宴 咽 衍 腌
睚	亚 呀 压 严 雅 牙 押 涯 鸭 丫 吖 芽 讶 哑 鸦
鹞	要 约 药 摇 邀 腰 妖 耀 遥 咬 谣 岆 瑶 姚 钥
郗	西 喜 习 吸 媳 晰 稀 溪 夕 兮 茜 犀 烯 熄 嬉
鲷	表 教 掉 脚 巧 桥 描 胶 吊 辽 骄 屌 雕 钓 硝
燧	士 队 诉 随 斯 适 岁 虽 贵 素 碎 蚀 髓 遂 隧
脲	调 脑 掉 晓 鸟 尿 屌 喵 瞧 雀 搅 蕉 飙 轿 侨
纞	建 联 连 练 恋 脸 疗 链 炼 粮 怜 剪 莲 廉 帘
伥	场 常 唱 章 厂 涨 床 偿 昌 尝 虫 畅 肠 胀 倡
麤	顾 族 舞 鱼 促 粗 崔 逾 瑜 凸 醋 妒 吾 舆 巫
圞	管 乱 幻 缘 圆 卷 冠 链 缓 炼 览 烂 怨 泉 懒
镛	用 永 拥 勇 赢 洞 铜 庸 泳 涌 佣 咏 雍 棕 荧
剜	完 万 玩 晚 湾 弯 碗 挽 塆 丸 婉 顽 腕 宛 檀
戆	长 装 黄 章 状 涨 庄 妆 丈 撞 壮 荒 砖 闯 仗
齁	后 候 游 户 油 构 肉 尤 厚 忽 猴 侯 吼 喉 咒
釆	变 先 边 编 遍 填 仙 辩 辨 舰 羡 颠 咁 贬 鞭
濉	士 队 诉 随 斯 适 岁 虽 贵 素 碎 蚀 髓 遂 隧
淙	从 童 藏 综 聪 贡 洪 恭 葱 匆 丛 哄 沧 憧 耸
圜	原 院 元 远 源 愿 园 缘 圆 怨 援 袁 苑 冤 渊
爩	于 预 遇 域 余 雨 宇 愉 郁 愚 寓 裕 逾 瑜 舆
畦	起 七 器 弃 欺 骑 戚 契 漆 琪 崎 祁 麒 迄 杞
潴	主 住 助 祝 筑 猪 逐 珠 诸 竹 驻 柱 煮 丶 烛
鸜	去 区 取 曲 土 突 趣 趋 驱 屈 渠 娶 躯 佢 祛
敎	交 校 较 叫 角 脚 缴 焦 胶 骄 椒 郊 矫 搅 蕉
妪	于 预 遇 域 余 雨 宇 愉 郁 愚 寓 裕 逾 瑜 舆
嬲	调 脑 掉 晓 鸟 尿 屌 喵 瞧 雀 搅 蕉 浇 飙 轿
灪	于 预 遇 域 余 雨 宇 愉 郁 愚 寓 裕 逾 瑜 舆
秣	模 默 魔 末 摩 莫 磨 摸 膜 墨 陌 脉 寞 抹 漠
婳	话 化 花 华 婚 画 划 坏 湖 虎 挥 滑 魂 辉 夸
芗	想 相 像 向 象 项 响 香 享 乡 箱 详 翔 祥 湘
嫲	吗 妈 马 码 亚 怕 米 嘛 麻 猫 骂 玛 涯 咪 祂
矸	感 干 饭 敢 赶 甘 函 杆 肝 尴 蔓 腕 氮 赣 竿
査	找 展 查 志 债 咋 扎 炸 渣 诈 砸 闸 榨 眨 乍
闱	微 未 围 卫 威 唯 尾 薇 魏 韦 畏 蔚 巍 惟 纬
铧	话 化 花 华 婚 画 划 坏 湖 虎 挥 滑 魂 辉 夸
崮	股 故 古 顾 估 鼓 固 骨 孤 姑 谷 雇 辜 菇 咕
鞻	又 路 头 楼 否 录 露 豆 陆 漏 炉 喽 苟 陋 庐
钃	主 住 助 祝 筑 猪 逐 珠 诸 竹 驻 柱 煮 丶 烛
昰	什 实 师 试 世 视 式 使 失 识 示 士 适 饰 狮
嘁	起 七 器 弃 欺 骑 戚 契 漆 琪 崎 祁 麒 迄 杞
骠	交 票 疗 骗 漂 秒 朴 飘 苗 搅 浇 嫖 刁 僚 瞄
乀	福 父 负 富 府 夫 附 妇 浮 扶 伏 覆 芙 辐 阜
噘	觉 决 绝 阅 掘 爵 诀 崛 鞠 抉 倔 炬 厥 獗 谑
椽	产 转 环 穿 川 床 船 窗 串 闯 禅 喘 蝉 掺 铲
尓	二 而 儿 哦 尔 额 恶 恩 耳 饿 饵 噩 厄 贰 讹
麣	验 严 烟 颜 炎 艳 燕 盐 岩 掩 宴 咽 衍 腌 堰
倬	做 主 抓 著 桌 卓 捉 兆 拙 灼 浊 绰 酌 镯 诏
鹗	额 恶 俄 呃 饿 鹅 噩 厄 鄂 遏 娥 讹 扼 胺 峨
啖	但 单 研 担 蛋 淡 丹 染 旦 胆 诞 灿 稻 捣 耽
胴	动 东 空 懂 登 顶 灯 勇 冬 洞 董 隆 冻 栋 诵
洺	明 名 平 影 英 亲 命 病 盟 蒙 凌 鸣 铭 岭 冥
掮	前 千 签 潜 迁 欠 牵 歉 谦 遣 铅 乾 嵌 谴 黔
癵	管 乱 幻 缘 圆 卷 冠 链 缓 炼 览 烂 怨 泉 懒
翀	成 城 充 众 厂 冲 尝 聪 崇 虫 宏 畅 宠 洪 肠
窨	因 音 言 银 引 印 阴 隐 饮 姻 淫 瘾 吟 殷 尹
僖	西 喜 习 吸 媳 晰 溪 夕 兮 茜 犀 烯 熄 嬉 羲
镗	让 堂 唐 糖 汤 邦 躺 塘 趟 烫 廊 扛 棠 倘 裆
贽	之 知 只 质 值 智 纸 址 枝 脂 汁 吱 秩 稚 挚
螯	早 案 造 奥 澳 傲 熬 凹 瑶 敖 嗷 袄 菠 艹 蘑
丷	吧 八 把 博 版 爸 巴 骂 牙 拔 芭 罢 叭 尬 疤
嘬	穿 怀 坏 川 船 吹 拆 衰 柴 垂 摔 甩 淮 锤 喘
粿	国 过 果 左 伙 鬼 锅 郭 柜 洛 跪 裹 卦 咕 唾
亊	什 实 师 试 世 视 式 使 失 识 示 士 适 饰 狮
鹘	股 故 古 顾 估 鼓 固 骨 孤 姑 谷 雇 辜 菇 咕
喑	因 音 言 银 引 印 阴 隐 饮 姻 淫 瘾 吟 殷 尹
塚	中 种 重 证 整 充 红 终 众 钟 涨 忠 宠 虹 仲
恫	同 通 统 痛 童 铜 筒 桶 讼 躺 桐 彤 瞳 耸 珑
殁	模 默 魔 末 摩 莫 磨 摸 膜 墨 陌 脉 寞 抹 漠
徭	要 约 药 摇 邀 腰 妖 耀 遥 咬 谣 岆 瑶 姚 钥
畊	更 登 港 疼 蒙 疯 缝 蜂 耕 梗 庚 巩 枫 翁 耿
洄	回 汇 挥 灰 悔 辉 徽 毁 绘 恢 贿 讳 卉 晖 晦
祼	关 管 原 观 官 软 馆 惯 冠 钻 贯 灌 莞 罐 棺
逑	求 企 球 酒 秋 仇 丘 妞 岂 邱 囚 糗 岐 矜 沏
垅	龙 冷 弄 孔 凌 隆 涌 笼 哄 垄 彤 嵩 拢 珑 聋
韪	微 未 围 卫 威 唯 尾 薇 魏 韦 畏 蔚 巍 惟 纬
菘	送 龙 松 宋 纵 桑 涌 讼 诵 颂 桐 垄 巩 嵩 怂
吅	选 宣 旋 悬 暅 炫 玄 轩 萱 喧 渲 绚 璇 嬛 眩
槑	没 美 费 每 妹 媒 伟 危 梅 煤 魅 眉 玫 霉 枚
揠	亚 呀 压 嘛 雅 牙 押 涯 鸭 丫 吖 芽 祎 讶 哑
颞	结 姐 届 杰 截 捷 灭 邪 妮 憋 捏 孽 聂 邂 涅
呋	福 父 负 富 府 夫 附 妇 浮 扶 伏 覆 芙 辐 阜
燚	意 已 义 医 移 忆 仪 伊 谊 疫 毅 椅 溢 怡 颐
嗫	结 姐 届 杰 截 捷 灭 邪 妮 憋 捏 孽 聂 邂 涅
楽	了 乐 陆 野 雷 页 绿 厉 隔 鲁 肋 叻 偻 醴 鲈
篁	黄 床 皇 荒 凰 谎 慌 煌 晃 恍 桓 疮 幢 惶 簧
甙	代 海 孩 带 待 材 嘚 贷 莱 戴 呆 袋 歪 歹 黛
矍	觉 决 绝 阅 掘 爵 诀 崛 鞠 抉 倔 炬 厥 獗 谑
丅	下 西 喜 消 夏 俩 侠 瞎 霞 萧 虾 辖 峡 狭 暇
稗	百 白 改 爸 嘅 奶 抱 贝 拜 败 摆 拔 塞 迫 柏
楸	求 企 球 酒 秋 仇 丘 妞 岂 邱 囚 糗 岐 矜 沏
泺	落 罗 洛 朵 逻 裸 啰 萝 碌 螺 囖 搓 骆 锣 漯
哞	目 又 构 某 幼 奏 忧 谋 侯 募 沫 麽 牟 眸 垢
屐	己 机 几 系 计 记 基 际 季 鸡 圾 忌 稽 祭 棘
蠹	都 度 读 独 顾 舞 毒 督 杜 赌 肚 渡 堵 逾 妒
隂	因 音 言 银 引 印 阴 隐 饮 姻 淫 瘾 吟 殷 尹
蓼	教 料 聊 疗 乔 辽 雀 撩 寥 廖 僚 凋 缭 撂 潦
嫑	保 报 包 宝 导 抱 爆 暴 薄 耗 饱 堡 剥 胞 曝
阊	场 常 唱 厂 偿 昌 尝 畅 肠 倡 彰 舱 敞 樟 娼
笫	自 子 字 咨 仔 紫 姿 滋 兹 孜 籽 淄 梓 疵 呲
赉	来 代 再 赖 莱 埃 璃 唻 歪 粒 汰 沥 垒 吏 睐
垟	样 养 阳 党 杨 访 央 洋 扬 羊 仰 氧 旸 痒 烊
鱲	节 列 铁 烈 裂 猎 劣 咧 膊 喱 亵 砺 凛 拮 冽
狷	短 监 端 圈 卷 泉 俊 捐 犬 箭 劵 倦 娟 歼 眷
赭	这 着 者 折 喆 哲 浙 遮 柱 汁 煮 殖 辙 褶 辄
瞋	产 称 陈 沉 晨 彻 尘 辰 臣 趁 衬 肾 唇 帧 澈
曱	月 觉 与 越 血 雪 阅 孕 悦 跃 岳 御 掘 玥 渔
蠛	别 贴 揭 灭 蟹 憋 碟 茄 桔 鳎 咩 蔑 邂 榭 泯
炷	主 住 助 祝 筑 猪 逐 珠 竹 驻 柱 煮 丶 烛 株
嚄	活 或 货 火 获 伙 惑 耗 徽 毁 妥 霍 祸 琐 豁
箬	那 哪 妈 它 达 马 拿 纳 牙 闹 拟 娜 塌 呐 钠
碇	定 东 命 评 兴 顶 订 兵 迎 档 丁 鼎 橙 钉 盯
盥	关 管 观 官 软 馆 惯 冠 钻 贯 灌 莞 罐 棺 纶
踟	吃 持 至 迟 池 尺 赤 痴 驰 齿 耻 斥 侈 翅 炽
黢	去 区 取 曲 土 趣 趋 驱 屈 渠 堵 寓 娶 躯 佢
昉	方 放 房 防 访 扬 仿 芳 坊 汪 膀 妨 逢 旸 纺
槁	考 包 宝 靠 毛 倒 逃 遭 稿 糕 烤 曹 勘 燥 冇
绀	感 干 饭 敢 赶 甘 杆 肝 尴 腌 蔓 腕 氮 赣 竿
亻	人 本 认 门 任 稳 忍 仁 纹 苯 嫩 韧 壬 刃 恳
萘	能 男 白 难 奶 拜 败 盖 耐 奈 挨 哀 恼 乃 暧
诓	光 广 况 狂 宽 矿 框 谎 慌 煌 扛 旷 匡 簧 慷
恽	员 运 育 云 孕 允 晕 遵 韵 蕴 匀 芸 酝 耘 陨
娈	建 联 连 签 练 恋 脸 疗 链 炼 怜 剪 莲 廉 帘
嚟	理 里 力 利 历 励 厉 厘 璃 哩 荔 吏 篱 鲤 俐
鳟	怎 军 群 云 尊 伦 混 暂 滚 遵 巡 棍 匀 仑 钝
鳏	关 管 观 官 软 馆 惯 冠 钻 援 贯 灌 莞 罐 棺
屙	哦 额 恶 俄 呃 噩 厄 鄂 遏 娥 讹 扼 胺 峨 鳄
珥	二 而 儿 哦 尔 额 恶 恩 耳 饿 饵 噩 厄 遏 贰
皴	员 存 村 询 讯 轮 损 俊 寸 挫 敦 菌 韵 粹 勋
缦	男 满 谈 慢 漫 兰 蛮 曼 番 埋 迈 滥 婉 谭 衍
莳	什 实 师 试 世 视 式 使 失 识 示 士 适 室 饰
枋	方 放 房 防 访 扬 仿 芳 坊 汪 膀 妨 逢 旸 纺
勖	需 许 续 须 苏 序 附 虚 绪 徐 蓄 叙 旭 畜 絮
脘	完 万 玩 晚 湾 挖 弯 碗 挽 塆 丸 婉 顽 腕 宛
薮	由 楼 优 首 投 搜 鼠 猴 兜 署 肃 抖 嗽 艘 鱿
巜	开 快 块 怪 宽 乖 溃 慨 楷 恺 筷 盔 魁 槐 胯
篾	别 贴 揭 械 灭 蟹 憋 碟 桔 鳎 咩 蔑 邂 榭 泯
尅	可 科 客 课 克 刻 哭 颗 渴 壳 柯 磕 棵 噩 苛
叒	若 弱 锅 锁 朵 乳 逻 萝 琢 魄 梭 挪 饶 唾 锣
髙	高 告 搞 貌 毫 泡 澳 冒 郭 傲 甘 稿 糕 膏 镐
赧	男 难 南 干 演 满 版 晚 弹 暖 湾 沿 函 杆 堪
椟	都 度 读 独 顾 毒 督 杜 赌 肚 渡 堵 逾 瑜 妒
円	原 院 元 远 源 愿 园 缘 圆 怨 援 袁 苑 冤 渊
铩	失 识 啥 杀 沙 傻 厦 晒 蛇 纱 莎 屎 扇 叉 疏
蕤	若 罪 弱 瑞 绘 乳 恢 催 锐 怼 睿 髓 贿 遂 秽
炝	请 将 强 抢 穷 枪 墙 牵 姜 酱 腔 匠 呛 蔷 锵
桡	脑 搞 靠 毛 倒 跑 劳 操 纳 讨 奶 奥 闹 恼 枣
颀	起 其 器 欺 骑 戚 契 漆 琪 崎 祁 麒 迄 杞 亟
勰	些 解 谢 写 协 鞋 械 邪 谐 蟹 携 泄 蝎 歇 卸
棂	零 领 另 灵 令 龄 凌 玲 铃 陵 岭 菱 聆 伶 拎
啐	菜 鬼 嘴 醉 催 脆 挫 驰 齿 粹 翠 崔 锤 醋 搓
孖	自 子 字 咨 仔 紫 姿 兹 孜 籽 淄 梓 疵 呲 渍
児	二 而 儿 哦 尔 额 恶 恩 耳 饿 饵 噩 遏 贰 迩
轫	人 认 任 忍 仁 闷 笨 纹 苯 扔 韧 壬 刃 汾 汶
霈	内 配 培 围 陪 辈 赔 佩 啡 畏 沛 惫 呸 裴 胚
曩	放 男 房 杨 访 央 棒 洋 钢 仰 囊 旸 痒 沧 壤
昝	验 赞 咱 残 暂 蛮 曼 胖 叛 咽 氨 挽 塆 攒 楠
毎	没 美 每 妹 媒 伟 梅 煤 魅 眉 玫 霉 枚 昧 媚
玦	觉 节 决 绝 皆 掘 爵 骏 诀 崛 鞠 抉 倔 厥 拮
籼	现 限 险 显 县 鲜 陷 嫌 贤 羡 咁 纤 弦 宪 咸
讦	接 结 节 界 姐 介 街 借 截 揭 捷 戒 皆 劫 羯
峄	意 已 义 医 移 忆 仪 伊 谊 疫 毅 椅 溢 怡 颐
嫒	爱 继 批 哎 艾 唉 碍 埃 欸 挨 哀 滋 癌 矮 暧
薙	体 题 提 替 徒 兔 梯 踢 剔 漓 唧 惕 蹄 涕 剃
筮	什 实 师 试 世 视 式 使 失 识 示 士 适 室 饰
镚	并 仍 碰 萌 衡 崩 猛 彭 蚌 蹦 泵 耿 柄 懵 绷
舂	中 种 重 证 整 充 红 终 众 钟 涨 忠 宠 虹 仲
黩	都 度 读 独 顾 弟 毒 督 杜 赌 肚 渡 堵 逾 瑜
艋	等 名 更 朋 梦 忙 丰 盟 蒙 萌 猛 孟 逢 耕 耿
聃	但 单 导 嘚 担 蛋 淡 丹 旦 胆 诞 侃 捣 丸 耽
骝	六 流 离 究 留 刘 黎 柳 浏 溜 瘤 榴 硫 朽 谬
榉	车 局 居 举 巨 聚 距 拒 俱 惧 拘 矩 菊 橘 狙
蓖	必 毕 笔 币 逼 避 鼻 彼 壁 弊 蔽 屄 毙 庇 哔
甾	在 再 质 台 改 字 载 咨 灾 宅 栽 枝 癌 宰 哉
哂	身 神 深 称 申 审 甚 舍 沈 尘 伸 慎 肾 渗 绅
芫	验 严 烟 颜 炎 艳 燕 盐 岩 掩 宴 咽 衍 腌 堰
韫	员 运 研 云 孕 允 晕 遵 韵 蕴 匀 芸 酝 耘 陨
訫	心 新 信 习 线 写 幸 欣 辛 薪 贤 晰 芯 辖 鑫
鞥	冷 恩 疯 哼 昂 讽 棚 蚌 橙 澄 绷 凳 瞪 亨 烹
芨	己 机 几 系 计 记 基 际 季 鸡 圾 忌 稽 祭 棘
羣	论 确 取 群 趣 询 缺 勤 盾 滚 巡 敦 裙 旬 熏
偲	四 司 思 死 斯 食 依 礼 激 似 丝 私 撕 寺 肆
碓	对 度 规 队 独 惠 堆 兑 敦 馈 粹 锐 歹 怼 旳
沤	族 舞 鱼 木 苏 湖 估 欧 偶 喽 敷 喉 芦 殴 呕
寳	保 报 包 宝 标 波 抱 爆 暴 薄 柏 饱 堡 剥 胞
垓	该 海 改 载 财 排 概 菜 盖 泰 鬼 奈 肝 矮 抬
琇	修 秀 休 旧 羞 媳 仇 瞎 袖 绣 昔 膝 钮 锈 朽
丄	上 场 常 商 声 省 伤 航 厂 尚 赏 畅 桑 霜 牲
樯	强 亲 香 庆 乡 抢 凉 枪 墙 腔 遣 铅 呛 蔷 锵
墒	上 场 常 商 声 省 伤 航 厂 尚 赏 畅 桑 霜 牲
埼	起 器 欺 骑 戚 契 漆 琪 崎 祁 麒 迄 杞 亟 骐
岬	家 加 价 假 酒 佳 架 驾 甲 嘉 嫁 夹 贾 迦 钾
廪	李 林 尽 临 邻 猎 劣 琳 淋 赁 锌 沥 麟 霖 吝
屮	河 陈 扯 彻 撤 吓 尘 尺 厨 澈 嗤 蔗 褚 忱 琛
峤	表 晓 巧 桥 乔 敲 喵 悄 瞧 雀 嵌 侨 翘 俏 窍
孛	费 北 备 背 卫 悲 贝 雷 违 辈 杯 倍 呗 碑 卑
弁	难 盘 判 残 胖 艳 燕 坎 尴 盼 潘 叛 攀 晗 帕
繇	注 周 州 洲 筑 猪 逐 珠 臭 猴 宙 舟 骤 轴 咒
髂	钱 价 气 器 架 欠 恰 戚 棋 瞧 峡 寝 窃 洽 邱
迳	经 精 京 景 警 竟 静 惊 竞 镜 净 敬 睛 径 晶
蹰	出 吃 处 初 除 楚 础 触 储 撤 池 厨 丶 橱 雏
汊	持 查 差 察 茶 插 尺 痴 莎 叉 诈 驰 齿 岔 茬
兲	天 团 限 千 简 田 填 甜 添 舔 帘 掂 碱 敛 癫
椴	观 店 款 远 段 断 短 端 怨 援 旋 贯 劝 垫 拳
甑	等 正 更 增 曾 登 仍 碰 赠 捧 鹏 冯 棚 睁 筝
绺	六 流 留 刘 柳 璃 扭 琳 浏 梨 溜 瘤 榴 硫 卤
吔	也 业 夜 爷 野 页 叶 宇 予 隔 液 耶 椰 冶 噎
缶	关 管 原 观 官 软 馆 惯 冠 钻 贯 灌 莞 罐 棺
焓	南 汉 韩 含 寒 涵 喊 汗 憾 函 撼 氨 旱 晗 焊
诒	意 已 义 医 移 忆 仪 伊 谊 疫 毅 椅 溢 怡 颐
凫	福 父 负 富 府 夫 附 浮 扶 伏 覆 芙 辐 阜 孵
沔	面 满 限 连 千 简 免 遍 眠 棉 绵 勉 扁 庙 鞭
圝	乱 券 幻 缘 圆 卷 酸 患 缓 炼 览 烂 怨 泉 捐
隗	快 哭 亏 徽 毁 阔 馈 愧 溃 葵 窥 盔 魁 奎 萃
翕	西 喜 习 吸 媳 晰 稀 溪 夕 兮 茜 犀 烯 嬉 羲
莼	初 春 纯 础 沉 尘 缠 趁 蠢 唇 锤 戳 馋 醇 淳
逋	不 部 步 补 布 速 宿 屋 欲 促 捕 怖 卜 埠 簿
氐	之 知 只 至 指 支 职 执 止 织 址 植 枝 芝 旨
逄	让 帮 朋 档 旁 胖 芳 彭 囊 塘 庞 萍 葬 磅 膨
桷	觉 决 绝 居 介 聚 掘 爵 曰 穴 诀 崛 抉 倔 厥
篪	吃 持 迟 池 尺 赤 痴 驰 齿 耻 斥 侈 翅 炽 嗤
篙	高 告 搞 貌 毫 泡 澳 冒 郭 傲 甘 稿 糕 膏 镐
侉	化 卡 华 划 苦 哭 酷 咯 跨 滑 夸 昆 愧 卦 垮
龖	大 打 带 达 答 呀 搭 娜 塔 涯 哒 坝 稻 嗒 鸦
裾	车 局 居 举 巨 距 拒 俱 惧 拘 矩 菊 焗 橘 狙
珪	规 贵 归 鬼 孤 柜 瓜 碎 轨 跪 瑰 桂 闺 粹 龟
暝	明 名 平 影 英 亲 命 盟 蒙 凌 鸣 铭 岭 冥 叮
蚬	现 限 险 显 县 鲜 陷 嫌 贤 羡 咁 纤 弦 宪 咸
鄯	山 善 删 闪 憾 扇 陕 擅 衫 珊 杉 悍 汕 姗 煽
罅	下 西 喜 消 夏 侠 瞎 霞 萧 虾 辖 峡 狭 屑 暇
悭	前 千 签 潜 迁 牵 歉 谦 遣 铅 乾 嵌 谴 黔 钳
怙	户 护 互 乎 湖 呼 胡 虎 忽 糊 狐 沪 壶 蝴 葫
媞	什 实 师 试 世 视 式 使 失 识 示 士 适 室 饰
蹟	己 机 几 系 计 记 基 际 绩 季 鸡 圾 忌 稽 祭
曈	同 通 总 统 痛 童 浓 铜 筒 桶 桐 艇 彤 瞳 捅
跹	现 限 险 显 县 鲜 陷 嫌 贤 羡 咁 纤 弦 宪 咸
炁	起 七 器 欺 骑 戚 契 漆 琪 崎 祁 麒 迄 杞 亟
嚅	如 入 母 故 诉 付 孤 吴 虎 予 乳 狱 腹 辱 儒
靐	平 影 并 领 形 病 灵 冰 兵 硬 屏 鸣 饼 凝 丙
琚	车 具 局 居 举 聚 距 拒 俱 惧 拘 矩 菊 焗 橘
钤	钱 千 签 迁 欠 牵 歉 谦 遣 铅 乾 倩 嵌 谴 黔
轸	真 镇 针 珍 震 阵 诊 振 侦 贞 甄 枕 帧 疹 臻
钚	不 部 步 补 布 速 独 曲 屋 欲 捕 怖 卜 寓 埠
笳	家 加 价 假 酒 佳 架 驾 甲 嘉 嫁 夹 贾 迦 钾
僮	同 通 统 痛 童 浓 恭 铜 筒 桶 桐 艇 彤 瞳 捅
蘖	结 姐 届 杰 截 捷 灭 邪 妮 憋 伱 斜 捏 孽 聂
糨	两 将 京 讲 江 奖 降 枪 晶 粮 疆 姜 酱 蒋 腔
叕	做 货 抓 著 桌 卓 捉 兆 拙 灼 浊 绰 酌 镯 诏
狲	军 询 索 寻 损 孙 碎 俊 晕 沦 蹲 仑 笋 酥 炖
辇	年 变 先 念 坚 免 填 链 谦 舰 羡 颠 咁 巅 碘
茆	毛 岛 猫 贸 貌 冒 矛 墨 咬 帽 捞 狸 庙 茅 冇
狎	下 西 喜 消 夏 俩 侠 瞎 霞 萧 虾 辖 峡 狭 屑
锨	现 限 险 显 县 鲜 陷 嫌 贤 羡 咁 纤 弦 宪 咸
蕞	最 汇 归 昨 纸 罪 址 尊 咨 鬼 嘴 灾 挥 醉 咀
顔	它 亚 呀 压 雅 牙 押 涯 鸭 狱 谊 丫 吖 芽 讶
埗	不 部 步 补 布 录 速 独 曲 屋 欲 捕 怖 卜 寓
跬	嘴 哭 亏 毁 阔 馈 愧 溃 葵 窥 盔 魁 奎 萃 匮
劼	接 节 姐 街 借 阶 届 杰 洁 截 揭 捷 劫 竭 桔
芘	被 批 皮 屁 脾 疲 匹 啤 劈 癖 坯 霹 琵 毗 媲
庹	落 讨 索 托 脱 锁 拖 拓 桃 陶 妥 萝 魄 陀 驼
杲	高 告 搞 貌 毫 泡 澳 冒 郭 傲 甘 稿 糕 膏 镐
镝	地 第 低 底 弟 递 帝 滴 迪 抵 敌 蒂 堤 笛 旳
馔	专 转 传 换 穿 状 川 赚 船 钻 撞 串 砖 唤 粘
辻	什 实 师 试 世 视 式 使 失 识 示 士 适 室 湿
邙	党 忙 盟 羊 岗 蒙 仰 昂 狼 茫 盲 躺 孟 芒 缸
哌	白 台 改 牌 排 拍 派 盖 哎 迫 埃 欸 挨 佩 哀
嶋	到 道 导 倒 岛 刀 丹 旦 冒 傲 戴 胆 盗 呆 邀
埕	成 程 城 声 承 诚 盛 乘 昌 衡 撑 呈 肠 秤 惩
龃	车 具 局 居 举 聚 距 俱 惧 拘 矩 菊 焗 橘 狙
谝	联 线 片 便 篇 骗 偏 贤 垫 眠 肩 歉 莲 朴 廉
忸	究 您 努 牛 逆 怒 柳 纽 扭 浏 妞 绣 捏 瘤 玖
庥	修 秀 休 旧 羞 媳 仇 袖 绣 昔 膝 钮 锈 朽 嗅
晷	规 贵 归 鬼 柜 瓜 轨 催 跪 瑰 桂 闺 粹 龟 硅
蹚	堂 央 唐 糖 汤 躺 塘 趟 碳 纺 烫 毯 棠 倘 淌
葑	风 丰 封 灯 峰 疯 凤 锋 奉 崩 猛 缝 蜂 冯 逢
瑷	爱 皮 哎 艾 唉 碍 埃 欸 挨 哀 晰 癌 矮 暧 楷
钹	包 博 播 波 伯 拨 玻 勃 搏 泊 驳 脖 敖 蜗 哺
梶	微 未 围 卫 威 唯 尾 慰 薇 魏 韦 畏 蔚 巍 惟
苄	变 先 边 编 健 遍 仙 辩 辨 舰 羡 颠 咁 贬 鞭
浐	产 称 察 串 憾 缠 擅 阐 禅 馋 杉 蝉 醇 憨 湛
酆	风 丰 封 灯 峰 疯 凤 锋 奉 崩 猛 缝 蜂 冯 逢
铯	特 格 科 思 呢 设 何 色 呵 速 萨 寺 瑟 涩 肆
俶	出 吃 处 初 除 楚 础 触 储 撤 厨 蔬 丶 橱 雏
龉	于 预 遇 域 余 雨 宇 愉 郁 愚 寓 逾 瑜 舆 俞
璘	李 林 临 邻 猎 劣 琳 淋 赁 锌 麟 霖 吝 磷 旻
怩	你 急 尼 拟 泥 逆 唉 妮 腻 伱 倪 霓 匿 昵 溺
晩	完 万 玩 晚 湾 挖 弯 碗 挽 塆 丸 婉 顽 腕 宛
钽	谈 范 慢 弹 探 坛 坦 摊 贪 叹 碳 滩 炭 吞 谭
曌	号 找 展 照 招 赵 桌 召 吵 耗 扎 兆 罩 昭 爪
篦	被 批 皮 屁 脾 疲 匹 啤 劈 癖 坯 霹 琵 毗 媲
镓	家 加 价 假 佳 架 驾 甲 嘉 嫁 夹 贾 煎 迦 钾
冏	经 讲 江 境 景 奖 竟 竞 穷 径 晶 胸 井 酱 囧
谂	身 神 深 称 申 审 甚 舍 沈 尘 伸 慎 肾 贞 渗
疴	哦 额 恶 俄 呃 鹅 噩 鄂 遏 娥 讹 扼 胺 峨 鳄
飝	费 非 飞 伟 肥 菲 废 啡 肺 妃 匪 沸 绯 嘞 翡
瑭	堂 央 棒 唐 糖 汤 躺 塘 趟 碳 沧 烫 彤 壤 毯
楦	选 宣 旋 悬 暅 炫 玄 轩 萱 喧 渲 绚 璇 嬛 眩
毖	比 必 毕 笔 币 逼 避 鼻 壁 碧 鄙 辟 臂 蔽 屄
鱻	现 限 险 显 县 鲜 陷 嫌 贤 羡 咁 纤 弦 宪 咸
箓	路 陆 绿 鲁 鹿 炉 卢 碌 撸 芦 璐 卤 禄 噜 泸
嗰	个 格 歌 各 哥 喝 革 固 隔 割 戈 葛 鸽 阁 瑟
楫	己 机 集 击 激 辑 既 肌 寂 忌 稽 饥 姬 嫉 脊
暌	嘴 哭 亏 毁 阔 馈 愧 溃 葵 窥 盔 魁 奎 萃 匮
镫	当 等 登 灯 仍 邓 彭 橙 澄 蹭 盯 耿 懵 凳 瞪
垌	同 通 统 痛 童 恭 铜 筒 桶 桐 艇 彤 瞳 聋 捅
纥	和 合 何 呵 河 核 喝 盒 泽 荷 吓 赫 贺 禾 嗨
凼	当 党 档 唐 荡 昂 挡 桑 纺 庞 痒 磅 瞪 壤 肪
珣	训 询 寻 讯 损 迅 循 巡 炫 逊 旬 勋 熏 捆 驯
郞	浪 朗 仓 汤 览 烂 懒 狼 郎 廊 澜 菱 磅 琅 梆
箸	主 住 助 祝 筑 猪 逐 珠 竹 驻 柱 煮 丶 烛 株
埸	意 已 义 医 移 忆 仪 伊 谊 疫 毅 椅 溢 怡 颐
飏	样 英 养 阳 杨 央 棒 洋 扬 羊 仰 盈 氧 旸 痒
铟	因 音 银 引 印 迎 阴 隐 饮 姻 谨 淫 瘾 吟 殷
龗	零 领 另 灵 令 龄 凌 玲 铃 陵 岭 菱 聆 伶 拎
齾	亚 呀 压 雅 牙 罚 押 涯 鸭 叭 丫 吖 芽 讶 哑
菽	书 术 属 述 输 树 舒 叔 殊 暑 鼠 署 疏 蔬 抒
筚	比 必 毕 笔 币 逼 避 鼻 壁 碧 鄙 辟 臂 蔽 屄
檎	您 器 琴 勤 侵 秦 邻 仇 寝 氢 乞 锌 钦 禽 沁
麷	风 丰 封 灯 峰 疯 凤 锋 奉 崩 猛 缝 蜂 冯 逢
骢	东 从 统 融 聪 崇 浓 苍 庸 葱 匆 丛 诵 蓉 雍
尜	哪 该 哈 格 它 干 达 巴 挂 孤 扒 爬 葛 塌 尬
窣	局 诉 速 素 舞 苏 呼 宿 俗 趋 塑 狱 腹 肃 醋
蕖	去 区 取 曲 土 趣 趋 驱 屈 渠 蓄 娶 躯 佢 祛
猢	户 护 互 乎 湖 呼 胡 虎 忽 糊 狐 沪 壶 蝴 葫
揆	嘴 哭 亏 毁 阔 馈 愧 溃 葵 窥 盔 魁 奎 萃 匮
斫	或 找 昨 伙 著 赵 桌 卓 霍 捉 丶 佐 拙 椎 缀
阗	天 千 简 田 填 甜 添 舔 帘 掂 碱 敛 毯 癫 黏
姵	内 配 培 围 陪 辈 赔 佩 啡 畏 沛 惫 呸 裴 胚
嶷	意 已 义 医 移 忆 仪 伊 谊 疫 毅 椅 溢 怡 颐
淸	情 请 清 亲 青 轻 庆 订 倾 井 晴 秉 卿 擎 氢
塍	成 程 城 声 承 诚 盛 乘 衡 撑 呈 肠 秤 惩 甸
戗	强 奖 良 抢 潜 辆 枪 墙 歉 腔 倩 嵌 呛 黔 绛
哚	多 锅 堆 盾 盗 拖 夺 朵 哆 啰 躲 堕 琐 剁 嗦
搵	文 问 微 温 粉 闻 稳 纷 纹 吻 畏 挽 丸 雯 蚊
齤	全 款 权 远 段 券 泉 劝 拳 犬 罐 乾 倦 倩 嵌
胍	户 护 互 乎 湖 呼 胡 虎 忽 糊 狐 沪 壶 蝴 葫
玠	结 界 介 街 借 阶 洁 揭 捷 皆 劫 竭 桔 诫 睫
抟	原 院 选 元 团 软 摊 援 旋 贯 拳 眷 臀 渲 猿
溱	千 器 青 琴 勤 侵 秦 邻 仇 寝 氢 乞 锌 钦 禽
幷	平 影 并 领 形 病 灵 竟 冰 兵 屏 鸣 饼 凝 婷
摺	这 着 者 致 折 喆 哲 浙 遮 煮 旨 吱 辙 褶 辄
恵	回 汇 挥 灰 悔 徽 毁 绘 恢 贿 讳 卉 晖 晦 荟
砦	制 海 找 孩 择 址 债 炸 晒 宅 栽 摘 诈 旨 寨
趄	接 结 求 且 切 铁 截 侵 漆 窃 岂 屑 祈 伽 茄
淝	费 非 飞 伟 肥 菲 废 啡 肺 妃 匪 沸 绯 嘞 翡
躅	主 住 助 祝 筑 猪 逐 珠 竹 驻 柱 煮 丶 烛 株
螟	明 名 平 影 英 亲 命 病 盟 蒙 凌 鸣 铭 岭 冥
眞	真 镇 针 珍 圳 震 阵 诊 振 侦 甄 枕 帧 疹 臻
妗	进 金 今 近 尽 仅 紧 津 禁 劲 斤 锦 肩 滨 谨
茔	应 影 英 营 迎 硬 映 赢 盈 颖 婴 鹰 樱 莹 荧
刿	规 贵 归 鬼 柜 瓜 碎 轨 跪 瑰 桂 闺 龟 硅 棍
汜	四 司 思 死 斯 食 礼 似 丝 私 撕 寺 肆 饲 嘶
収	手 收 书 受 周 首 售 洲 守 搜 厚 授 丑 筹 寿
産	产 场 差 潮 炒 缠 阐 禅 巢 蚕 馋 罕 蝉 掺 铲
埇	用 永 拥 勇 宗 纵 庸 婴 泳 涌 佣 咏 桐 垄 巩
垸	原 院 元 远 源 愿 园 缘 圆 怨 援 袁 苑 冤 渊
綫	现 限 险 显 县 鲜 陷 嫌 贤 羡 咁 纤 弦 宪 咸
趔	利 介 列 借 临 烈 裂 黎 莉 猎 劣 蝶 咧 榴 膊
讟	都 度 读 独 顾 舞 毒 督 杜 赌 肚 渡 堵 逾 妒
俬	四 司 思 死 斯 食 礼 似 丝 私 撕 寺 肆 饲 嘶
锶	红 共 送 供 融 松 宋 讼 轰 诵 颂 雍 嵩 怂 耸
戡	看 男 难 玩 凡 颜 咱 刊 惨 燃 摊 盐 堪 砍 坎
薨	东 功 红 终 综 宏 洪 虹 鸿 轰 笼 佣 哄 弘 雍
彘	之 知 只 至 指 支 职 执 止 织 址 植 枝 芝 旨
荜	比 必 毕 笔 币 逼 避 鼻 壁 碧 鄙 辟 臂 蔽 屄
驫	表 变 校 标 暴 脚 秒 飘 浇 飙 彪 婊 刁 僚 镖
耨	友 候 又 头 构 某 偷 幼 奏 忧 漏 奴 呦 吼 妞
竜	总 龙 弄 孔 凌 隆 涌 笼 垄 彤 嵩 拢 珑 聋 伶
堺	结 界 姐 介 街 借 阶 洁 揭 捷 劫 竭 桔 诫 睫
氡	动 东 农 懂 痛 弄 冬 洞 董 浓 贡 冻 庸 栋 凳
葶	定 清 顶 订 迎 档 硬 丁 径 冻 鼎 钉 盯 冥 叮
荇	行 性 星 精 亲 形 型 兴 幸 醒 姓 刑 睛 馨 璟
笕	间 见 检 坚 荐 键 剑 兼 践 鉴 尖 浅 剪 艰 肩
虪	数 书 术 属 束 树 舒 叔 暑 署 疏 抒 赎 薯 墅
椐	车 具 局 句 举 聚 距 俱 惧 拘 矩 菊 焗 橘 狙
菈	拉 啦 礼 雅 罚 鲁 娜 塔 垃 辣 牢 蜡 腊 碌 坝
椤	或 落 左 罗 洛 逻 裸 啰 萝 堕 螺 囖 卤 噜 烙
驽	付 足 句 努 屋 欲 促 距 幅 督 怒 豫 拘 喻 奴
窸	西 喜 习 吸 媳 晰 稀 溪 夕 兮 茜 犀 烯 熄 嬉
鸮	小 笑 消 销 效 晓 孝 肖 萧 削 宵 潇 嚣 霄 硝
璠	反 班 言 饭 范 翻 烦 犯 探 访 凡 繁 返 泛 番
雫	那 哪 妈 它 达 马 拿 纳 牙 闹 拟 娜 塌 呐 钠
镒	意 已 义 医 移 仪 伊 谊 疫 毅 椅 溢 怡 颐 咦
瑀	于 预 遇 域 余 雨 宇 愉 郁 愚 寓 裕 逾 瑜 舆
虋	们 门 温 闻 蒙 敏 纷 闷 眉 玫 狠 嫩 昧 韧 蔓
喹	嘴 哭 亏 毁 阔 馈 愧 溃 葵 窥 盔 魁 奎 萃 匮
犽	亚 呀 压 雅 牙 押 涯 鸭 叭 丫 吖 芽 讶 哑 鸦
峩	额 恶 俄 呃 鹅 噩 厄 鄂 遏 娥 讹 扼 胺 峨 鳄
礽	更 朋 曾 忍 仍 碰 萌 扔 孟 逢 蚌 壬 梗 藤 蓬
菸	于 预 遇 域 余 雨 宇 愉 郁 愚 寓 裕 逾 瑜 舆
氺	说 水 世 视 式 税 睡 碎 徽 毁 氏 蚀 匙 侍 抒
貘	模 默 魔 末 摩 莫 磨 摸 膜 墨 陌 脉 寞 抹 漠
饸	和 合 何 呵 测 河 核 喝 射 盒 荷 吓 赫 贺 阁
娭	爱 继 哎 艾 唉 碍 埃 欸 挨 哀 晰 癌 矮 暧 楷
炆	文 问 位 微 温 卫 粉 闻 稳 纷 纹 吻 畏 挽 丸
怿	意 已 义 医 移 仪 伊 谊 疫 毅 椅 溢 怡 颐 咦
騳	都 度 读 独 顾 弟 毒 督 杜 赌 肚 渡 堵 逾 瑜
橼	原 院 元 远 源 愿 缘 圆 怨 援 袁 苑 冤 渊 媛
卩	节 界 介 街 借 阶 洁 揭 捷 劫 羯 竭 桔 诫 睫
厵	原 院 元 远 源 愿 缘 圆 怨 援 袁 苑 冤 渊 媛
魃	吧 八 把 爸 巴 拔 芭 罢 涯 怖 叭 弊 啪 疤 坝
氽	论 土 询 迅 腿 盾 吐 拖 敦 菌 吞 旬 熏 屯 芸
鹩	票 叫 效 料 聊 疗 漂 辽 搅 浇 撩 寥 廖 刁 僚
猹	注 查 咋 召 扎 炸 渣 诈 詹 挚 闸 榨 眨 乍 诧
鼐	能 男 白 难 台 奶 盖 耐 奈 挨 哀 恼 癌 乃 亥
呒	马 母 阿 模 码 米 噢 寞 抹 牧 弥 漠 墓 募 咪
蛄	股 故 古 顾 估 鼓 固 骨 孤 姑 谷 雇 菇 咕 沽
踯	之 知 只 至 指 支 职 执 止 织 址 植 枝 芝 旨
毑	接 结 节 界 街 阶 洁 截 揭 皆 竭 桔 诫 睫 婕
汆	原 院 选 环 软 援 寸 串 旋 贯 悬 眷 渲 猿 惭
壅	用 总 永 童 拥 勇 庸 婴 泳 涌 佣 咏 桐 雍 躬
粝	理 里 历 礼 丽 励 厉 梨 粒 哩 漓 篱 鲤 俐 俪
佥	前 千 签 迁 欠 牵 歉 谦 遣 铅 乾 倩 嵌 谴 黔
魕	己 机 集 击 激 吉 辑 既 肌 寂 忌 稽 饥 姬 嫉
澪	零 领 另 灵 令 龄 凌 玲 铃 陵 岭 卿 菱 聆 伶
鬻	车 具 局 句 举 聚 距 拒 俱 惧 拘 矩 菊 焗 橘
叡	罪 瑞 辉 瑰 桂 馈 锐 硅 睿 髓 讳 葵 茹 卉 褪
瑠	六 流 究 留 例 刘 旧 厉 柳 浏 溜 瘤 榴 硫 璐
蒴	水 或 书 刷 伙 束 树 舒 著 硕 梳 戳 淑 梭 朔
妫	规 贵 归 鬼 柜 轨 毁 醉 跪 瑰 桂 闺 龟 硅 卦
楝	联 连 险 练 恋 脸 链 炼 怜 莲 廉 奠 帘 掂 敛
馐	修 秀 休 旧 羞 媳 仇 锡 袖 绣 昔 膝 钮 锈 朽
夲	本 班 备 闻 奔 倍 纷 宾 搬 笨 氛 狠 愤 苯 瓣
穰	让 房 望 防 党 仿 荡 邦 仰 昂 杠 壤 肪 镑 烊
韾	因 音 银 引 印 迎 阴 隐 饮 姻 抑 淫 瘾 吟 殷
肼	经 京 景 警 竟 静 竞 镜 净 径 晶 井 颈 荆 靖
歩	不 部 步 补 布 录 速 独 曲 宿 屋 捕 怖 卜 堵
镲	处 持 差 察 茶 插 扎 叉 缠 禅 刹 巢 岔 茬 诧
蠍	些 解 谢 写 协 鞋 械 邪 谐 蟹 携 泄 蝎 歇 卸
洹	欢 款 远 婚 换 环 惯 幻 患 缓 唤 喘 娟 憨 媛
蹼	普 欲 促 铺 吐 辅 污 谱 悟 扑 浦 葡 菩 埔 仆
亍	出 吃 处 初 除 楚 础 触 储 池 厨 蔬 丶 橱 雏
洧	微 未 围 卫 威 谓 唯 尾 慰 薇 魏 畏 蔚 巍 惟
笄	己 计 级 及 集 极 即 急 激 继 鸡 吉 肌 挤 忌
巛	婚 村 困 润 顿 孙 孕 晕 昆 坤 旬 沦 葵 仑 捆
歺	额 恶 俄 呃 鹅 噩 厄 鄂 遏 娥 讹 扼 胺 峨 鳄
铍	批 皮 屁 脾 疲 匹 披 啤 劈 癖 坯 霹 琵 毗 媲
瓠	股 故 古 顾 估 鼓 固 骨 孤 姑 谷 雇 辜 菇 咕
萁	其 七 气 器 妻 戚 棋 琦 凄 祁 麒 迄 杞 祺 亟
鬰	于 预 遇 域 余 雨 宇 愉 郁 愚 寓 裕 逾 瑜 舆
哓	小 笑 消 销 效 漂 晓 孝 肖 萧 削 宵 潇 嚣 霄
舺	家 加 价 假 酒 佳 架 驾 甲 嘉 嫁 夹 贾 迦 钾
饐	意 已 义 医 移 仪 伊 谊 疫 毅 椅 溢 怡 颐 咦
镔	近 毕 伴 宾 滨 辨 谨 斌 彬 昕 濒 荫 哔 缤 殡
豕	什 实 师 试 世 视 式 使 失 识 示 士 适 室 湿
靊	更 风 曾 登 丰 封 峰 疼 疯 凤 锋 奉 缝 蜂 冯
桖	学 解 续 血 询 雪 阅 鞋 讯 蓄 巡 泄 叙 岳 蝎
騱	西 喜 习 吸 媳 晰 稀 溪 夕 兮 茜 犀 烯 熄 嬉
泅	求 且 企 球 秋 仇 丘 岂 韭 邱 囚 糗 岐 矜 沏
辋	网 当 完 望 王 往 忘 藏 访 央 棒 亡 仰 旺 汪
颏	还 百 该 海 孩 载 害 彩 赛 奶 汇 耐 摆 寨 咳
仵	无 务 物 午 舞 误 吴 屋 污 乌 伍 雾 呜 勿 吾
碛	其 七 气 器 妻 戚 棋 琦 凄 祁 麒 迄 杞 祺 亟
籱	抓 筑 著 桌 卓 捉 兆 拙 缀 灼 浊 绰 酌 镯 诏
爧	零 领 另 灵 令 龄 凌 玲 铃 陵 岭 菱 聆 伶 拎
豸	之 知 只 至 指 支 职 执 止 织 址 枝 芝 旨 吱
酢	作 做 错 座 左 坐 租 索 昨 措 桌 遭 惑 夺 阻
扽	困 蛋 毒 顿 盾 敦 逊 裙 吨 蹲 芸 镀 囤 舵 笋
卝	关 管 观 官 馆 惯 冠 钻 贯 灌 莞 罐 棺 纶 眷
呔	代 孩 带 待 态 嘚 贷 莱 戴 呆 袋 歪 踩 歹 黛
顠	销 票 偏 漂 妙 尿 乔 抛 朴 飘 瞧 嫖 蝙 凋 瓢
笏	无 务 物 午 舞 误 吴 屋 污 悟 乌 伍 雾 呜 勿
顟	老 报 络 倒 跑 劳 闹 腰 矛 篮 牢 捞 姥 佬 拦
棹	号 找 展 照 招 赵 桌 召 吵 耗 扎 兆 罩 昭 爪
醮	展 站 战 占 珍 粘 胀 撼 兆 擅 颤 詹 沾 斩 湛
庠	想 相 像 向 象 项 响 香 享 乡 箱 详 翔 祥 湘
妺	模 默 魔 末 摩 莫 磨 摸 膜 墨 陌 脉 寞 抹 漠
闩	算 换 环 刷 赚 缓 闪 摔 甩 霜 擅 汕 煽 栓 痪
婼	若 弱 锅 锁 朵 乳 逻 萝 琢 魄 梭 挪 饶 唾 锣
皲	军 均 尊 伦 混 君 俊 允 敦 菌 逊 裙 筋 勋 骏
檩	李 林 尽 临 邻 猎 劣 琳 淋 赁 锌 麟 霖 吝 磷
洇	也 业 夜 爷 野 页 叶 宇 予 隔 液 耶 椰 冶 噎
蠿	主 抓 筑 著 桌 卓 捉 兆 拙 灼 浊 绰 酌 镯 诏
栢	百 报 海 孩 白 般 拜 败 暴 摆 莱 戴 柏 霾 歹
坭	你 李 急 尼 拟 泥 逆 妮 腻 伱 倪 霓 匿 昵 溺
骺	后 候 游 户 油 构 肉 尤 厚 忽 猴 侯 吼 喉 苟
苫	身 山 申 善 删 闪 扇 缠 陕 擅 衫 珊 杉 汕 绅
蓊	更 朋 嗡 登 丰 盟 亡 萌 衡 赠 旺 泵 雯 翁 耿
襦	如 入 故 诉 付 孤 吴 宇 虎 乳 狱 腹 雾 肃 辱
鸷	之 知 只 至 指 支 职 执 止 织 址 枝 芝 旨 吱
逡	存 权 群 训 琴 裙 犬 娶 蕴 囤 醛 酝 隽 痊 珺
蚧	接 结 节 界 介 街 借 阶 洁 截 揭 皆 竭 桔 诫
晸	重 正 证 政 整 省 争 涨 征 郑 症 忠 挣 蒸 绳
鸰	零 领 境 另 灵 令 龄 凌 玲 铃 陵 岭 菱 聆 伶
骓	制 追 灰 悔 辉 桌 柱 坠 株 嘱 咀 铸 诛 拙 蛛
氖	能 代 再 哪 该 孩 载 牌 脑 财 菜 奶 耐 妮 奈
様	想 相 像 向 象 项 响 香 享 乡 箱 详 翔 祥 湘
椋	两 量 联 香 享 亮 良 娘 链 辆 梁 凉 粮 怜 谅
饙	分 份 飞 粉 奋 菲 疯 废 纷 氛 奉 愤 芬 妃 嫩
増	怎 增 曾 腾 萌 坑 哼 赠 孟 枫 翁 蓬 僧 愣 亨
恚	回 汇 挥 慧 灰 悔 徽 毁 绘 恢 贿 讳 卉 晖 晦
柢	地 第 低 底 弟 递 帝 滴 迪 抵 敌 蒂 堤 笛 旳
胪	路 录 绿 鲁 鹿 炉 卢 碌 撸 璐 卤 庐 禄 噜 泸
苌	场 常 张 唱 厂 偿 昌 尝 畅 宠 肠 倡 禅 馋 敞
仡	意 已 易 义 医 移 仪 伊 谊 疫 毅 椅 溢 怡 颐
榧	费 非 飞 伟 肥 菲 废 卑 啡 肺 妃 匪 沸 绯 翡
杓	少 找 杀 绍 烧 稍 闪 召 吵 纱 嫂 衫 邵 哨 煞
鹮	选 宣 旋 悬 暅 炫 玄 轩 萱 喧 渲 绚 璇 嬛 眩
滏	福 父 负 富 府 夫 附 浮 扶 伏 覆 芙 辐 阜 孵
猡	或 落 左 罗 洛 逻 裸 啰 萝 堕 螺 囖 卤 噜 驼
萜	些 解 结 谢 姐 贴 铁 帖 邪 携 卸 憋 叠 剔 谍
桜	应 影 英 迎 硬 映 赢 盈 颖 婴 鹰 樱 荧 蝇 萤
丼	经 京 景 警 静 惊 竞 镜 净 径 晶 井 颈 荆 靖
郾	验 严 烟 颜 炎 艳 燕 盐 岩 掩 宴 咽 衍 腌 堰
嗞	自 子 资 字 咨 仔 紫 姿 滋 兹 籽 淄 梓 疵 呲
蒌	又 路 头 楼 否 录 露 豆 陆 漏 炉 喽 苟 陋 庐
蚍	批 皮 屁 脾 疲 匹 披 啤 劈 癖 坯 霹 琵 毗 媲
澶	但 单 担 蛋 淡 丹 旦 胆 诞 稻 侃 捣 丸 耽 氮
镬	活 或 货 火 获 伙 惑 耗 徽 毁 妥 霍 祸 琐 豁
仂	了 乐 陆 野 雷 页 绿 厉 隔 鲁 肋 叻 偻 醴 鲈
蛉	零 领 境 另 灵 令 龄 凌 玲 铃 陵 岭 菱 聆 伶
蕻	容 红 忠 宏 孔 宠 哼 隆 浓 贡 洪 虹 鸿 轰 哄
荦	或 落 左 罗 洛 逻 裸 啰 萝 堕 螺 囖 卤 噜 驼
畀	必 毕 笔 币 逼 避 鼻 彼 壁 弊 蔽 屄 毙 庇 哔
忄	心 新 信 习 线 幸 林 欣 辛 献 薪 晰 溪 芯 鑫
瀞	经 京 景 警 竟 惊 竞 镜 净 敬 径 晶 井 颈 荆
荽	队 随 斯 适 岁 虽 碎 嘘 肆 梭 髓 遂 隧 穗 隋
硖	下 解 吸 夏 侠 瞎 霞 虾 卸 辖 峡 狭 隙 锌 玺
螭	吃 持 迟 池 尺 赤 痴 驰 齿 耻 斥 翠 侈 翅 炽
丌	其 七 气 器 妻 戚 棋 凄 祁 麒 迄 杞 祺 亟 岐
吽	后 候 游 户 油 构 肉 尤 厚 忽 猴 侯 吼 喉 苟
鲭	情 请 强 清 亲 青 轻 庆 硬 竞 倾 晴 秉 卿 擎
鲧	管 故 敢 挂 尊 滚 允 肝 棍 蕴 峻 棺 丨 隽 盹
逖	体 题 提 益 替 梯 踢 剔 伺 狄 惕 蹄 涕 剃 嚏
谖	选 宣 旋 悬 暅 炫 玄 轩 萱 喧 渲 绚 璇 嬛 眩
恂	训 询 虚 寻 讯 迅 循 巡 逊 旬 勋 熏 靴 驯 薰
焜	婚 困 润 顿 孙 孕 晕 昆 阔 坤 旬 沦 葵 仑 捆
铋	必 毕 笔 币 逼 避 鼻 彼 壁 弊 蔽 屄 毙 庇 哔
帙	之 知 只 至 指 支 职 执 止 织 址 枝 芝 旨 吱
槲	户 护 互 乎 湖 呼 胡 虎 忽 糊 狐 沪 壶 蝴 葫
隰	西 喜 习 吸 媳 晰 稀 溪 夕 兮 茜 犀 烯 熄 嬉
璩	去 区 取 曲 土 趣 趋 驱 屈 渠 寓 狐 娶 躯 佢
殳	数 书 术 属 述 束 树 舒 叔 殊 暑 鼠 署 疏 蔬
诹	走 由 周 楼 优 住 投 油 欧 奏 竹 诱 猴 兜 驻
槊	活 少 熟 伙 烧 叔 锁 硕 琐 朔 蜀 嗦 竖 邵 烁
跩	专 择 怀 坏 赚 宅 砖 衰 摘 摔 寨 甩 淮 撰 坠
砻	东 从 龙 控 综 宏 隆 洪 筒 笼 垄 菱 拢 珑 聋
挹	意 已 易 义 医 移 仪 伊 谊 疫 毅 椅 溢 怡 颐
嫰	文 问 怎 份 粉 闻 仁 氛 狠 愤 吻 嫩 粪 焚 啃
邾	主 住 助 祝 筑 猪 逐 珠 朱 诸 竹 驻 柱 丶 烛
衽	人 认 任 肯 忍 仁 闷 笨 纹 苯 扔 韧 壬 刃 汾
殍	销 票 偏 漂 焦 尿 乔 抛 朴 飘 瞧 饺 嫖 蝙 凋
硐	动 东 容 共 懂 龙 童 订 综 丁 冬 洞 聪 董 冻
褔	福 父 负 富 府 夫 附 妇 浮 扶 伏 覆 芙 辐 阜
喾	付 足 句 苦 库 哭 酷 宿 咯 屋 欲 促 裤 狱 腹
蚨	复 福 父 负 富 府 夫 附 妇 浮 伏 覆 芙 辐 阜
愍	民 命 紧 敏 蛮 秦 邻 绵 殷 闽 旻 闵 悯 忻 谩
胝	之 知 只 至 指 支 职 执 止 织 址 枝 芝 旨 吱
邴	平 影 并 领 形 病 灵 竟 冰 兵 硬 竞 屏 鸣 饼
畹	完 万 玩 晚 湾 挖 弯 碗 挽 塆 丸 婉 顽 腕 榄
隈	未 围 卫 威 唯 尾 慰 薇 魏 畏 蔚 巍 惟 纬 猥
忝	天 限 连 千 简 田 填 甜 添 舔 帘 掂 碱 敛 滇
焐	无 务 物 午 舞 误 屋 污 悟 乌 伍 呜 勿 吾 巫
鸫	动 等 东 共 懂 龙 永 订 丁 冬 洞 聪 董 贡 冻
蒗	放 浪 洋 钢 朗 昂 隆 粮 狼 郎 痒 沧 廊 愣 琅
濞	批 皮 屁 脾 疲 匹 披 啤 劈 癖 坯 霹 琵 毗 媲
沇	验 严 烟 颜 炎 艳 燕 盐 沿 掩 宴 衍 腌 堰 俨
箪	但 单 担 蛋 淡 丹 旦 胆 诞 稻 侃 捣 丸 耽 氮
荭	容 红 聪 恒 宏 哼 隆 浓 贡 洪 虹 鸿 轰 哄 弘
亽	系 计 级 及 即 急 吉 既 剂 肌 寂 挤 忌 脊 羁
俣	于 预 遇 域 余 雨 宇 愉 郁 愚 寓 裕 逾 瑜 舆
牝	品 片 音 尽 频 临 拼 贫 淋 潘 匹 鑫 叛 钦 沁
绗	程 声 省 诚 征 衡 凤 恒 横 哼 冯 蒸 扔 昇 逢
炘	心 新 信 今 线 写 幸 欣 辛 献 闲 仙 薪 晰 芯
疳	感 班 干 演 敢 馆 赶 甘 懒 杆 肝 砍 尴 赣 竿
苴	些 解 谢 写 协 鞋 械 邪 谐 蟹 携 泄 蝎 歇 卸
诮	脚 巧 桥 乔 谦 敲 悄 瞧 雀 倩 浇 侨 翘 俏 窍
郄	西 喜 息 吸 惜 媳 晰 夕 锡 兮 茜 隙 玺 烯 嬉
嬿	验 严 烟 颜 炎 艳 燕 盐 沿 掩 宴 咽 衍 腌 堰
隹	直 职 治 追 抓 嘴 筑 恢 枝 芝 坠 咀 椎 缀 帜
郇	欢 管 源 换 环 惯 幻 患 缓 唤 撰 哗 喘 娟 蒜
欤	于 预 遇 域 余 雨 宇 愉 郁 愚 寓 裕 逾 瑜 舆
氅	场 常 张 唱 厂 偿 昌 尝 畅 宠 肠 倡 禅 馋 敞
樘	挺 堂 唐 糖 汤 芳 脏 躺 塘 趟 烫 冈 镑 秧 棠
渌	路 鲁 鹿 炉 卢 碌 撸 芦 璐 卤 禄 噜 泸 虏 麓
坼	河 陈 扯 彻 撤 吓 尘 尺 厨 澈 嗤 蔗 褚 忱 琛
旼	民 命 漫 敏 蛮 邻 琳 淫 闽 旻 闵 悯 忻 冕 谩
篼	度 由 否 斗 豆 沟 幼 逗 兜 堵 抖 痘 喽 酉 喉
彀	候 又 够 购 构 狗 沟 奏 勾 雇 钩 苟 釉 逅 垢
婠	完 亚 怕 娃 挖 哇 瓦 蜡 勿 挽 啪 袜 靶 鸦 腕
峇	可 科 色 卡 客 课 克 刻 颗 渴 壳 柯 磕 棵 苛
厍	设 社 属 史 核 啥 摄 舍 射 涉 蛇 奢 舌 匙 赎
氘	到 道 导 倒 岛 刀 澳 旦 冒 傲 戴 胆 盗 呆 邀
铌	你 急 笔 尼 拟 泥 逆 亦 唉 妮 腻 伱 倪 霓 匿
禩	四 司 思 死 斯 食 礼 似 丝 私 撕 寺 肆 饲 嘶
儍	使 失 识 啥 杀 沙 傻 厦 晒 纱 莎 屎 扇 疏 洒
捩	接 流 利 介 列 借 略 烈 裂 黎 莉 猎 劣 蝶 咧
菰	股 故 古 顾 估 鼓 固 骨 孤 姑 谷 雇 辜 菇 咕
碶	其 期 七 气 器 妻 戚 棋 凄 祁 麒 迄 杞 祺 亟
帏	未 围 卫 威 唯 慰 薇 魏 畏 蔚 巍 惟 纬 猥 萎
喈	结 节 界 介 街 借 阶 洁 揭 捷 皆 劫 竭 诫 睫
磴	当 等 登 灯 仍 碰 邓 彭 橙 澄 蹭 盯 耿 懵 凳
凊	情 请 清 亲 青 轻 庆 硬 竞 倾 晴 秉 卿 擎 氢
鲔	未 围 卫 威 唯 慰 薇 魏 畏 蔚 巍 惟 纬 猥 萎
乩	计 级 及 集 即 急 吉 既 剂 寂 挤 忌 脊 羁 畸
唵	安 案 按 翻 暗 岸 燕 俺 氨 鞍 妍 敖 晏 惋 摁
揸	制 找 查 志 债 珠 咋 扎 炸 渣 诈 闸 榨 眨 乍
煳	户 护 互 乎 湖 呼 胡 虎 忽 糊 狐 沪 壶 蝴 葫
缁	自 子 资 字 咨 仔 紫 姿 兹 孜 籽 淄 梓 疵 呲
逦	理 里 历 礼 例 丽 励 厉 梨 粒 哩 漓 篱 鲤 俐
槭	顾 族 舞 鱼 促 粗 崔 逾 瑜 芦 凸 醋 妒 吾 舆
狛	被 破 婆 霸 坡 喔 抹 颇 泼 渤 袍 珀 陂 茉 莆
卐	完 万 玩 晚 湾 弯 碗 挽 塆 丸 婉 彦 顽 腕 宛
帑	挺 堂 唐 糖 汤 仿 狼 芳 躺 塘 趟 烫 秧 嚷 棠
镞	组 足 族 租 虚 陆 巨 库 偶 聚 祖 阻 卒 诅 戮
艿	能 代 再 哪 该 孩 载 牌 菜 奶 耐 奈 碍 乃 唻
啱	验 延 炎 燕 盐 沿 岩 掩 宴 咽 衍 彦 腌 堰 晏
姮	程 声 省 诚 征 衡 凤 恒 横 哼 冯 蒸 扔 昇 逢
剡	验 延 炎 燕 盐 沿 岩 掩 宴 咽 衍 彦 腌 堰 晏
関	关 管 原 观 官 馆 惯 冠 贯 灌 莞 罐 棺 纶 竿
犭	全 欢 观 权 券 缓 欠 怨 泉 劝 拳 玄 犬 劵 诠
囟	心 新 信 习 线 幸 林 欣 辛 献 薪 晰 溪 芯 鑫
饧	行 性 并 星 形 型 兴 幸 醒 欣 姓 刑 馨 杏 腥
眭	士 诉 随 斯 适 岁 虽 碎 肆 梭 髓 遂 隧 穗 隋
聼	听 清 景 挺 停 庭 厅 兵 迎 堂 颖 婷 亭 廷 霆
峁	马 毛 猫 末 贸 貌 冒 矛 妖 炮 迈 烤 苗 帽 茅
腧	书 术 属 述 输 束 树 舒 叔 殊 暑 鼠 署 疏 蔬
黉	程 声 省 诚 征 衡 凤 恒 横 哼 冯 蒸 扔 昇 逢
橐	都 度 读 独 顾 弟 毒 督 杜 赌 肚 渡 堵 逾 妒
蒺	计 级 及 集 即 急 吉 既 剂 寂 挤 脊 羁 畸 藉
旃	展 站 战 占 粘 胀 撼 兆 颤 旱 詹 沾 斩 湛 绽
烜	回 汇 挥 慧 灰 悔 徽 毁 绘 恢 贿 讳 卉 晖 晦
魈	小 笑 消 销 效 晓 孝 霞 肖 萧 削 宵 潇 轿 嚣
寤	务 物 武 舞 吴 污 悟 乌 伍 呜 勿 巫 唔 坞 梧
怛	大 打 带 达 答 怕 搭 抵 塔 涯 哒 疤 坝 嗒 鸦
糌	验 严 赞 咱 残 暂 曼 胖 叛 咽 撼 氨 挽 攒 楠
鳔	表 标 笑 消 销 票 乔 胞 朴 钓 瞧 飙 彪 婊 镖
缃	想 相 像 强 向 象 项 响 香 享 乡 箱 详 翔 祥
崀	放 浪 钢 朗 昂 隆 粮 狼 郎 靓 趟 痒 沧 妄 烫
羰	统 挺 堂 唐 糖 汤 摊 芳 脏 躺 塘 趟 烫 秧 棠
胼	片 便 限 连 简 篇 骗 田 偏 扁 嵌 巅 碘 奠 帘
浈	真 镇 针 珍 圳 震 阵 诊 振 侦 贞 枕 帧 疹 臻
莨	相 两 量 另 享 亮 良 链 辆 梁 凉 粮 狼 怜 谅
庅	模 默 魔 末 摩 莫 磨 摸 膜 墨 陌 脉 寞 抹 漠
谰	担 络 兰 蓝 览 烂 懒 篮 栏 鞍 滥 旱 攒 拦 澜
臜	卡 嘛 杂 紫 擦 阻 砸 兹 燥 嗒 攒 帕 袜 嘎 枣
萩	求 且 企 球 酒 秋 仇 丘 妞 韭 邱 囚 糗 矜 沏
餍	验 严 烟 颜 炎 艳 燕 盐 沿 岩 掩 宴 咽 衍 腌
鲮	零 领 另 灵 令 龄 凌 玲 铃 陵 岭 菱 聆 伶 拎
薜	比 必 毕 笔 币 逼 避 闭 鼻 弊 辟 蔽 屄 毙 庇
奭	什 实 师 试 世 视 式 使 失 示 士 适 室 湿 饰
苾	比 必 毕 笔 币 逼 避 闭 鼻 弊 辟 蔽 屄 毙 庇
谠	当 党 档 唐 荡 昂 挡 纺 庞 痒 磅 瞪 壤 莽 裆
宀	面 满 千 简 免 遍 眠 棉 绵 勉 庙 鞭 遣 衔 乾
纡	于 预 遇 域 余 雨 宇 愉 郁 愚 寓 豫 裕 逾 瑜
柰	能 代 再 哪 该 海 孩 载 牌 脑 菜 奶 耐 妮 奈
毐	爱 继 哎 艾 唉 碍 埃 欸 挨 哀 晰 癌 矮 暧 吏
沩	未 围 卫 威 唯 慰 薇 魏 畏 蔚 巍 惟 纬 猥 萎
柊	中 种 重 正 证 充 红 终 众 钟 涨 忠 宠 虹 仲
茑	教 疗 鸟 尿 瞧 浇 翘 嚼 酵 嫖 碾 婊 廖 绞 哮
聱	友 又 游 由 优 油 右 邮 尤 幼 忧 幽 悠 犹 诱
岢	可 科 色 卡 客 课 克 刻 颗 渴 壳 柯 磕 棵 苛
浉	十 事 实 师 试 世 视 式 使 失 示 士 适 室 湿
馑	进 金 今 近 尽 仅 紧 津 禁 劲 斤 锦 谨 晋 巾
缟	高 告 搞 貌 毫 泡 澳 冒 郭 傲 甘 稿 糕 膏 镐
洌	接 流 利 介 列 借 烈 裂 黎 莉 猎 劣 蝶 咧 榴
妘	员 运 云 孕 允 晕 遵 韵 蕴 匀 芸 酝 耘 陨 昀
錾	验 严 赞 咱 残 暂 曼 胖 叛 咽 撼 氨 挽 攒 楠
炟	大 打 单 带 达 答 呀 搭 娜 塔 涯 哒 疤 稻 嗒
玘	计 级 及 集 即 急 吉 既 剂 寂 挤 脊 羁 畸 藉
疍	但 单 导 担 蛋 淡 湾 丹 旦 胆 诞 侃 耽 氮 郸
銭	前 钱 千 签 潜 迁 牵 歉 谦 遣 铅 乾 倩 嵌 黔
熘	六 流 究 留 例 列 刘 厉 柳 浏 溜 瘤 榴 硫 璐
鉄	些 结 谢 姐 贴 铁 帖 携 憋 叠 剔 谍 咩 膊 蔑
庑	务 物 武 舞 吴 污 悟 乌 伍 呜 勿 巫 唔 坞 梧
鸱	只 质 值 至 职 治 智 止 织 址 枝 芝 旨 滞 秩
吲	因 今 音 银 引 印 阴 隐 饮 姻 淫 瘾 吟 殷 尹
糁	身 社 神 深 称 申 审 甚 沈 伸 慎 肾 渗 汕 绅
鋆	员 运 云 孕 允 晕 遵 韵 蕴 匀 芸 酝 耘 陨 昀
浯	务 物 武 舞 吴 污 悟 乌 伍 呜 勿 巫 唔 坞 梧
缂	可 科 卡 客 课 克 刻 页 颗 渴 壳 柯 磕 棵 苛
黙	模 默 魔 末 摩 莫 磨 摸 膜 墨 陌 脉 寞 抹 漠
玎	定 清 顶 订 迎 档 硬 丁 径 冻 鼎 钉 盯 冥 叮
屾	身 社 神 深 称 申 审 甚 沈 伸 慎 肾 渗 汕 绅
鲎	后 候 游 户 油 构 肉 尤 厚 忽 猴 侯 吼 喉 陡
锜	其 期 七 气 器 妻 戚 棋 凄 祁 麒 迄 杞 祺 亟
舖	普 欲 促 铺 吐 辅 污 谱 悟 驱 扑 浦 葡 菩 埔
嫱	将 强 亲 香 乡 抢 枪 墙 腔 铅 呛 仟 蔷 锵 阡
怍	作 做 错 座 左 坐 租 索 昨 措 桌 遭 惑 夺 阻
鸶	四 司 思 死 斯 食 似 丝 私 撕 寺 肆 饲 嘶 厮
缫	号 宝 刀 散 缩 傲 盗 邀 扫 曝 骚 嫂 冇 豹 叁
轳	路 录 陆 绿 鲁 鹿 卢 碌 撸 璐 禄 噜 泸 虏 麓
洸	关 光 广 观 港 冠 逛 荒 框 谎 灌 罐 煌 晃 旷
伭	选 宣 旋 悬 暅 炫 玄 轩 萱 喧 渲 绚 璇 嬛 眩